Item Type,Types Of Items,Item Count,Disabled Item Count,Active Item Count,Max Checked Out,Max Checked Out Date,Utilization
Tools,24,267,105,162,48,2024-01-25 11:12:00,29.6
Hand Tools,80,1355,631,724,209,2024-01-18 18:56:00,28.9
Shovels & Digging,10,56,18,38,23,2024-01-20 12:11:00,60.5
Spade Shovel,1,13,7,6,3,2018-03-21 15:09:00,50.0
Square Shovel,1,15,4,11,6,2024-01-15 19:55:00,54.5
Round Point Shovel,1,8,3,5,5,2019-06-01 10:38:00,100.0
Planters Shovel,1,5,1,4,4,2024-01-25 19:31:00,100.0
Digging Fork,1,1,1,0,0,,
Snow Shovel,1,13,2,11,8,2024-01-09 18:51:00,72.7
Rakes,11,37,11,26,7,2018-05-05 11:37:00,26.9
Metal Garden Rake,1,13,2,11,4,2022-10-15 10:29:00,36.4
Hand Rake,1,4,0,4,1,2018-03-14 20:24:00,25.0
Thatching Rake,1,1,0,1,0,,0.0
Steel Rake,1,1,0,1,0,,0.0
Leaf Rake,1,3,1,2,2,2021-04-03 11:46:00,100.0
Pruners,5,41,8,33,16,2024-01-21 16:24:00,48.5
Loppers,1,11,3,8,5,2024-01-21 16:24:00,62.5
Hand Pruner,1,25,5,20,11,2024-01-25 19:31:00,55.0
Telescopic Pruner,1,2,0,2,3,2024-01-06 11:58:00,150.0
Fruit Pickers,1,3,0,3,3,2017-09-02 10:24:00,100.0
Axes,6,19,13,6,8,2024-01-22 18:27:00,133.3
Hatchet,1,6,4,2,3,2021-06-12 09:56:00,150.0
Wedge,1,1,0,1,2,2022-02-09 20:47:00,200.0
Hand Axe,1,7,5,2,3,2024-01-22 18:27:00,150.0
Maul,1,1,1,0,1,2017-06-04 18:27:00,inf
Saws,13,183,84,99,32,2024-01-18 18:56:00,32.3
Hand Miter Saws,1,15,5,10,4,2020-10-03 11:54:00,40.0
Bow Saws,1,4,0,4,4,2022-12-03 10:53:00,100.0
Hack Saws,1,27,15,12,7,2024-01-06 11:43:00,58.3
Coping Saw,1,14,4,10,3,2022-12-18 17:00:00,30.0
Back Saws,1,17,4,13,3,2018-01-07 16:53:00,23.1
Crosscut Saws,1,2,1,1,0,,0.0
Drywall Saws,1,2,0,2,1,2018-06-20 20:45:00,50.0
Hole Saws,1,7,3,4,3,2018-08-19 17:49:00,75.0
Hole Saw Kits,1,4,2,2,4,2024-01-07 16:30:00,200.0
Key Hole Saws,1,35,20,15,4,2019-07-01 19:26:00,26.7
Wrenches,12,340,121,219,40,2024-01-21 16:34:00,18.3
Torque Wrench,1,8,1,7,9,2024-01-25 11:13:00,128.6
Pipe Wrenches,1,35,11,24,6,2017-02-01 19:01:00,25.0
Basin Wrench,1,13,2,11,2,2018-07-10 17:00:00,18.2
Belt Strap Wrench,1,12,5,7,4,2024-01-08 21:01:00,57.1
Chain Wrench,1,3,0,3,2,2017-05-10 19:07:00,66.7
Adjustable Wrench,1,54,20,34,15,2024-01-18 18:56:00,44.1
Lock Nut Wrench,1,5,1,4,1,2017-10-22 17:14:00,25.0
Open End Wrench,1,72,36,36,3,2018-05-16 19:23:00,8.3
Spanner Wrenches,1,19,2,17,0,,0.0
Wrench Sets,10,451,233,218,52,2024-01-20 12:56:00,23.9
Socket Sets,1,243,147,96,34,2024-01-20 11:56:00,35.4
Allen Wrench Sets,1,57,29,28,11,2024-01-08 18:56:00,39.3
Spark Plug Wrench Set,1,5,1,4,1,2020-01-11 12:01:00,25.0
Box Wrench Sets,1,24,8,16,2,2021-04-13 20:49:00,12.5
Ratcheting Wrench Sets,1,3,3,0,1,2018-09-04 18:16:00,inf
Open End Wrench Sets,1,3,1,2,0,,0.0
Combination Wrench Sets,1,114,44,70,7,2021-09-01 20:09:00,10.0
Measuring & Layout Tools,15,247,102,145,73,2024-01-18 18:57:00,50.3
Levels,1,52,26,26,20,2024-01-10 20:37:00,76.9
Tape Measures,1,45,31,14,4,2024-01-11 18:51:00,28.6
Calipers,1,8,3,5,2,2018-09-12 19:56:00,40.0
Chalklines,1,10,1,9,1,2018-01-27 11:08:00,11.1
Squares,1,46,11,35,21,2024-01-21 13:34:00,60.0
Yardsticks,1,6,2,4,3,2024-01-13 12:06:00,75.0
Rulers,1,20,4,16,3,2019-06-02 19:03:00,18.8
Stud finder,1,25,9,16,23,2024-01-25 18:55:00,143.8
Plumb Bob,1,1,1,0,0,,
T-Bevels,1,2,1,1,3,2024-01-16 20:22:00,300.0
Contour Gauges,1,7,3,4,3,2024-01-16 20:22:00,75.0
Compasses (drawing),1,4,2,2,1,2017-07-23 17:41:00,50.0
Marking,1,4,2,2,0,,0.0
Scrapers,5,101,47,54,16,2024-01-18 18:54:00,29.6
Paint Scraper,1,23,12,11,3,2019-09-16 18:37:00,27.3
Sidewalk Ice Scraper,1,1,0,1,1,2020-08-29 11:53:00,100.0
Planes,1,27,19,8,6,2019-06-02 19:03:00,75.0
Chisels & Gouges,4,121,59,62,32,2024-01-26 08:19:00,51.6
Cement Chisel,1,7,4,3,2,2017-07-29 09:46:00,66.7
Cold Chisel,1,8,4,4,1,2016-07-02 11:41:00,25.0
Wood Chisel,1,24,7,17,10,2024-01-26 08:19:00,58.8
Drills,1,18,8,10,9,2024-01-13 10:32:00,90.0
"Bits, Drivers and Accessories",2,112,65,47,47,2024-01-15 19:55:00,100.0
Drill Bits,1,74,38,36,42,2024-01-15 19:55:00,116.7
Screwdrivers,6,562,309,253,61,2024-01-18 18:56:00,24.1
Flat Screwdrivers,1,257,151,106,19,2024-01-08 21:03:00,17.9
Phillips Screwdrivers,1,179,115,64,16,2023-12-23 11:54:00,25.0
Torx Screwdrivers,1,36,6,30,13,2024-01-18 18:23:00,43.3
Screwdriver Sets,1,27,11,16,4,2021-09-29 19:37:00,25.0
Robertson Screwdrivers,1,9,4,5,2,2018-08-14 16:38:00,40.0
Clamps & Brackets,13,305,146,159,81,2024-01-26 08:19:00,50.9
C-Clamps,1,103,45,58,21,2022-07-31 16:45:00,36.2
Bar Clamps,1,59,26,33,40,2024-01-25 11:13:00,121.2
Corner Clamp,1,14,13,1,11,2018-01-27 12:14:00,1100.0
Quick Grip Clamp,1,54,32,22,18,2020-08-08 13:02:00,81.8
Wood Clamp,1,3,1,2,1,2023-03-01 20:51:00,50.0
Drill Press Clamps,1,1,0,1,1,2017-06-18 16:55:00,100.0
Hand Clamps,1,31,14,17,6,2017-04-15 10:18:00,35.3
Vises,1,15,6,9,6,2024-01-26 08:19:00,66.7
Pipe Clamps,1,7,2,5,3,2024-01-23 18:34:00,60.0
Web Clamps,1,8,2,6,2,2022-10-11 20:36:00,33.3
Saw Blades,4,11,3,8,3,2019-10-07 18:45:00,37.5
Table Saw Blades,1,1,0,1,1,2019-07-20 10:58:00,100.0
Dado Saw Blades,1,5,1,4,1,2018-06-06 20:55:00,25.0
Hammers & Mallets,11,140,93,47,28,2024-01-23 18:10:00,59.6
Rubber Mallets,1,15,10,5,6,2022-12-20 20:38:00,120.0
Sledgehammers,1,9,2,7,5,2022-06-07 18:51:00,71.4
Ball Peen Hammers,1,5,2,3,2,2017-10-29 17:31:00,66.7
Claw Hammers,1,91,72,19,18,2024-01-21 18:59:00,94.7
Framing Hammers,1,2,0,2,1,2016-11-30 19:25:00,50.0
Tack Hammers,1,4,0,4,1,2019-08-27 19:29:00,25.0
Ladders,10,16,4,12,9,2024-01-22 18:27:00,75.0
Step Ladders,1,5,2,3,4,2022-11-02 20:25:00,133.3
Multi Ladder,1,2,0,2,3,2024-01-22 18:27:00,150.0
Knives,5,103,67,36,18,2024-01-23 19:03:00,50.0
Linoleum Knives,1,10,4,6,2,2024-01-16 20:42:00,33.3
Putty Knife,1,18,11,7,4,2017-11-19 18:04:00,57.1
Utility Knives,1,54,37,17,12,2024-01-23 19:03:00,70.6
Wall Knives,1,1,0,1,0,,0.0
"Pliers, Cutters, and Snips",10,237,91,146,44,2024-01-18 18:34:00,30.1
Slip Joint Pliers,1,48,13,35,10,2024-01-18 18:34:00,28.6
Wire Cutters,1,39,14,25,8,2021-11-06 11:27:00,32.0
Needle Nose Pliers,1,50,24,26,9,2023-09-10 18:48:00,34.6
Lineman Plier,1,3,1,2,2,2018-05-19 09:57:00,100.0
Locking Pliers,1,4,1,3,1,2017-06-17 10:19:00,33.3
Bolt Cutters,1,9,4,5,5,2023-10-04 20:30:00,100.0
Buckets,1,37,20,17,5,2022-01-22 10:16:00,29.4
Extension Poles,1,7,0,7,5,2023-01-07 09:48:00,71.4
Brushes and Rollers,11,235,102,133,35,2024-01-25 19:31:00,26.3
Sharp Bristle Brushes,1,24,9,15,3,2018-10-20 11:40:00,20.0
Counter Brush,1,4,1,3,1,2017-05-24 19:10:00,33.3
Smoothing Brush,1,1,0,1,0,,0.0
Paint Guide,1,10,4,6,3,2017-06-14 20:23:00,50.0
Paint Roller Frame,1,54,18,36,13,2023-01-07 09:49:00,36.1
Roller Tool,1,5,1,4,2,2017-06-14 20:23:00,50.0
Sanders,1,29,18,11,5,2021-04-03 10:13:00,45.5
Strippers,1,1,1,0,0,,
Crimpers,1,12,2,10,3,2023-02-05 18:07:00,30.0
Pry Bars & Crowbars,7,49,20,29,26,2024-01-21 18:59:00,89.7
Crowbars,1,15,6,9,7,2024-01-21 18:59:00,77.8
Nail Puller,1,12,3,9,4,2023-03-04 11:16:00,44.4
Pry Bar,1,22,11,11,15,2023-10-07 10:14:00,136.4
Hand Tool Sets,1,9,3,6,1,2019-08-14 19:45:00,16.7
Trimmers,2,8,7,1,2,2018-05-05 10:12:00,200.0
Manual Hedge Trimmers,1,6,5,1,1,2022-09-18 18:20:00,100.0
Misc Hand Tools,1,47,36,11,1,2016-05-22 17:25:00,9.1
Edgers,3,12,3,9,5,2021-04-10 11:32:00,55.6
Manual Lawn Edger,1,7,1,6,5,2021-04-10 11:32:00,83.3
Manual Lawn Edger,1,7,1,6,5,2021-04-10 11:32:00,83.3
Tool Stands & Work Tables,5,33,12,21,13,2024-01-20 11:02:00,61.9
Saw Horses,1,21,9,12,10,2024-01-20 11:02:00,83.3
Table Rollers,1,4,2,2,2,2019-02-16 11:55:00,100.0
Tool Bench Work Mate,1,2,0,2,2,2022-06-29 18:37:00,100.0
Vise Grips,1,14,6,8,4,2022-08-09 19:11:00,50.0
Locks and Security,1,1,0,1,1,2019-03-24 18:49:00,100.0
Tap and Die,1,21,13,8,3,2017-11-26 16:51:00,37.5
Planters,1,4,2,2,1,2017-02-25 11:06:00,50.0
Pitchfork,1,7,4,3,2,2017-08-30 16:03:00,66.7
Hand Truck,1,4,3,1,3,2018-03-28 17:58:00,300.0
Drill Press (hand),1,1,1,0,1,2016-10-12 20:08:00,inf
Staple Guns,3,34,18,16,15,2024-01-23 20:56:00,93.8
Manual Staple Guns,1,6,1,5,9,2024-01-23 20:56:00,180.0
Tin Snips,1,13,5,8,4,2019-05-12 18:45:00,50.0
Tube Cutters,1,10,1,9,3,2022-04-27 18:52:00,33.3
Pipe Cutters,1,11,2,9,2,2020-08-08 10:48:00,22.2
Lawn Mower,1,8,1,7,5,2022-07-12 18:55:00,71.4
Shears,3,3,1,2,2,2019-05-11 10:40:00,100.0
Metal Shears,1,1,0,1,1,2017-12-16 12:14:00,100.0
Trowels & Floats,9,94,39,55,13,2024-01-16 20:42:00,23.6
Notched Trowel,1,35,15,20,7,2022-03-13 18:19:00,35.0
Trowel,1,20,10,10,3,2021-06-19 11:05:00,30.0
Brick Trowel,1,9,4,5,3,2017-10-14 09:29:00,60.0
Corner Trowel,1,7,1,6,1,2016-07-10 18:22:00,16.7
Tuck Point Trowel,1,1,1,0,1,2022-12-07 21:01:00,inf
Float,1,13,3,10,4,2024-01-16 20:42:00,40.0
Caulk Guns,1,39,21,18,7,2022-04-24 16:19:00,38.9
Conduit Benders,1,4,1,3,1,2016-11-13 17:55:00,33.3
Machete,2,4,2,2,2,2022-02-09 20:47:00,100.0
Rivet Tools,1,10,1,9,1,2018-03-07 16:56:00,11.1
Squeegees,1,12,4,8,3,2018-05-12 11:02:00,37.5
Dollies,1,26,9,17,20,2024-01-14 17:12:00,117.6
Hex Keys,1,3,0,3,0,,0.0
Mixers & Dispensers,2,1,1,0,1,2020-01-05 18:39:00,inf
Watering Tools,1,2,0,2,0,,0.0
Cultivators,1,4,1,3,2,2019-03-20 20:42:00,66.7
Testers (hand held),1,4,1,3,2,2022-08-16 21:36:00,66.7
Augers & Drain Openers,3,12,5,7,10,2024-01-21 16:55:00,142.9
Manual Drain Auger,1,5,2,3,2,2017-05-06 11:04:00,66.7
Toilet Auger,1,1,0,1,3,2024-01-07 19:00:00,300.0
"Files, Awls & Punches",7,124,76,48,16,2024-01-06 10:50:00,33.3
Files,1,84,56,28,13,2022-05-01 18:17:00,46.4
Punches,1,22,8,14,4,2022-03-08 19:07:00,28.6
Awl,1,3,3,0,1,2017-05-24 20:56:00,inf
Rasps,1,14,9,5,4,2024-01-06 10:50:00,80.0
Center Punches,1,1,0,1,1,2019-03-09 12:07:00,100.0
Hoists & Trolleys,2,3,0,3,2,2022-10-23 16:52:00,66.7
Chain Hoist,1,3,0,3,2,2022-10-23 16:52:00,66.7
"Scythes, Sickles & Machetes",4,10,3,7,3,2022-02-22 18:04:00,42.9
Hand Sickle,1,1,0,1,0,,0.0
Scythe,1,5,1,4,2,2018-05-26 10:19:00,50.0
Machete,2,4,2,2,2,2022-02-09 20:47:00,100.0
Sharpeners,2,15,5,10,14,2024-01-04 19:10:00,140.0
Finishing Stones,1,9,2,7,12,2024-01-04 19:10:00,171.4
Drywall Tools,5,44,21,23,7,2017-10-04 21:08:00,30.4
Drywall Tool Sets,1,1,1,0,1,2022-07-16 09:44:00,inf
Joint Knives,1,5,3,2,2,2020-10-10 11:29:00,100.0
Bucket Scoops,3,18,11,7,3,2019-03-25 18:50:00,42.9
Taping Knives,1,12,6,6,3,2019-03-25 18:50:00,50.0
Electrical Tools,3,64,22,42,13,2024-01-23 19:47:00,31.0
Fish Tapes,1,2,0,2,3,2024-01-23 19:47:00,150.0
Wire Strippers,1,32,9,23,5,2023-08-22 20:56:00,21.7
Nail Sets,1,3,0,3,0,,0.0
Jigs,3,10,7,3,2,2022-09-06 20:10:00,66.7
Pocket Hole Jigs,1,4,4,0,1,2018-03-31 11:35:00,inf
Dovetail Jigs,1,1,1,0,0,,
Gear Pullers,1,7,1,6,4,2022-04-19 18:45:00,66.7
Hand Air Pumps,1,4,0,4,1,2022-06-08 18:17:00,25.0
Plug Cutters,1,2,0,2,1,2017-01-18 20:20:00,50.0
Paint Can Openers,1,5,0,5,1,2018-03-14 16:15:00,20.0
Cleaning Brushes,4,9,4,5,3,2024-01-23 19:03:00,60.0
Wire Brushes,1,4,1,3,1,2016-09-14 20:15:00,33.3
Woodworking Kits,1,4,0,4,1,2022-12-17 11:36:00,25.0
Pickaxes & Mattocks,5,11,5,6,5,2019-06-01 11:31:00,83.3
Pickaxes,1,7,4,3,3,2017-07-12 18:05:00,100.0
Pick Mattocks,1,3,0,3,2,2019-06-01 09:53:00,66.7
Power Tools,8,44,15,29,23,2024-01-18 18:59:00,79.3
Corded & Plug-in,40,260,134,126,116,2024-01-23 20:59:00,92.1
Power Drills,4,69,36,33,40,2024-01-10 20:37:00,121.2
Power Drill 1/2in,1,2,1,1,2,2022-08-06 10:28:00,200.0
Power Drill 3/8in,1,17,5,12,14,2023-12-23 12:11:00,116.7
Hammer Drills,1,3,3,0,2,2017-06-17 09:26:00,inf
Power Saws,11,127,56,71,50,2024-01-23 20:53:00,70.4
Circular Saws,2,43,22,21,22,2024-01-15 19:55:00,104.8
Scroller Power Saws,1,9,3,6,3,2024-01-18 18:57:00,50.0
Corded Miter Saws,3,14,9,5,6,2018-07-25 20:53:00,120.0
Compound Miter Saw,1,1,1,0,0,,
Jig Saws,1,42,14,28,20,2024-01-23 20:53:00,71.4
Table Saws,1,10,5,5,3,2020-01-18 11:34:00,60.0
Wet Tile Saws,1,7,4,3,4,2018-05-19 10:20:00,133.3
Band Saws,1,2,0,2,1,2016-10-23 18:18:00,50.0
Corded Trimmers,4,11,5,6,5,2022-08-06 10:49:00,83.3
Electric Hedge Trimmers,1,5,3,2,3,2019-09-11 19:01:00,150.0
Electric Lawn Edger,1,3,2,1,1,2016-09-17 09:36:00,100.0
Electric String Trimmer,1,2,0,2,1,2017-05-27 09:46:00,50.0
Extension Cords,1,72,37,35,40,2024-01-23 19:03:00,114.3
Electric Chippers,1,1,0,1,3,2024-01-08 19:05:00,300.0
Buffers,1,5,0,5,6,2023-12-19 19:13:00,120.0
Testers,4,25,6,19,8,2023-12-23 12:11:00,42.1
Circuit Testers,1,13,5,8,3,2020-08-01 10:17:00,37.5
Voltage Tester,1,10,1,9,5,2022-09-24 11:45:00,55.6
Sanders & Planers,11,94,51,43,47,2024-01-18 23:16:00,109.3
Random Orbit Sander,1,10,5,5,5,2022-06-28 18:26:00,100.0
Finishing Power Sanders,1,17,10,7,14,2024-01-13 11:50:00,200.0
Belt Sanders,1,19,8,11,10,2023-10-24 20:56:00,90.9
Power Planer,1,7,4,3,2,2017-05-14 16:19:00,66.7
Power Sanders,1,37,22,15,21,2024-01-23 19:53:00,140.0
Reciprocating Saw,1,14,5,9,11,2024-01-23 19:17:00,122.2
Soldering & Heat Guns,4,75,32,43,28,2024-01-16 18:27:00,65.1
Soldering Iron,1,44,17,27,16,2024-01-02 20:35:00,59.3
Heat Gun,1,10,7,3,4,2017-04-19 18:33:00,133.3
Hot Glue Gun,1,18,8,10,9,2024-01-16 18:27:00,90.0
Paint Sprayer,1,10,6,4,3,2019-07-15 18:38:00,75.0
Electric Dehydrators,1,5,1,4,3,2024-01-22 20:12:00,75.0
Routers,1,15,9,6,5,2019-10-12 09:32:00,83.3
Rotary Tools,3,34,23,11,9,2021-01-09 12:05:00,81.8
Dremel Multi Pro,1,23,14,9,5,2019-08-12 20:30:00,55.6
Roto Zip,1,5,4,1,1,2018-01-07 16:58:00,100.0
Drill Press (power),1,7,4,3,2,2017-06-24 11:08:00,66.7
Pressure Washers,2,9,7,2,4,2019-09-04 19:58:00,200.0
Pressure Washer Attachments,1,1,0,1,1,2022-12-13 21:13:00,100.0
Electric Air Pumps,1,2,1,1,1,2022-07-24 16:28:00,100.0
Chargers,3,51,23,28,17,2024-01-16 21:00:00,60.7
12v Battery Chargers,1,2,1,1,3,2024-01-16 21:00:00,300.0
Rechargeable Battery Charger,1,31,10,21,11,2024-01-14 18:40:00,52.4
Electric Leaf Blower,1,5,3,2,3,2021-07-13 19:08:00,150.0
Engraver,1,6,4,2,3,2023-01-14 12:01:00,150.0
Electric Pumps,3,3,0,3,1,2019-11-16 09:38:00,33.3
Submersible Pump,1,2,0,2,1,2019-11-16 09:38:00,50.0
Electric Mixers & Dispensers,3,9,3,6,2,2020-03-07 13:30:00,33.3
Electric Concrete Stirrers,1,3,1,2,2,2022-09-27 20:01:00,100.0
Paint Mixers & Stirrers,1,6,2,4,2,2022-01-22 10:16:00,50.0
Electric Augers & Drain Openers,1,1,0,1,1,2020-10-17 09:26:00,100.0
Vacuum Cleaners,4,32,13,19,19,2024-01-14 12:46:00,100.0
Wet-Dry Vac,1,23,8,15,18,2024-01-14 12:46:00,120.0
Handheld Vacuums,1,1,1,0,1,2017-04-29 12:18:00,inf
Upright Vacuums,2,1,1,0,1,2019-11-16 11:02:00,inf
Router Accessories,5,3,1,2,2,2024-01-11 18:51:00,100.0
Router Edge Guides,1,2,0,2,2,2024-01-11 18:51:00,100.0
Router Bits,9,9,1,8,0,,0.0
Straight Router Bits,1,4,0,4,0,,0.0
Molding Router Bits,1,1,0,1,0,,0.0
Frame & Panel Router Bits,1,1,0,1,0,,0.0
Corded Grinders,1,2,0,2,3,2023-12-06 20:50:00,150.0
Electric Nailers,1,1,0,1,1,2018-03-21 18:22:00,100.0
Steam Cleaners,5,7,6,1,4,2021-10-13 18:18:00,400.0
Carpet Steam Cleaners,1,3,3,0,3,2021-10-13 18:18:00,inf
Multi-surface Steam Cleaners,1,1,1,0,1,2017-08-05 10:43:00,inf
Cordless Power Tools,18,133,74,59,65,2024-01-21 16:46:00,110.2
Cordless Drills,1,63,38,25,31,2024-01-21 16:46:00,124.0
Flashlights,1,14,7,7,3,2020-10-03 09:36:00,42.9
Cordless Trimmers,1,11,6,5,5,2017-05-13 12:06:00,100.0
Cordless Saws,2,8,2,6,8,2023-11-25 10:58:00,133.3
Cordless Circular Saw,1,4,2,2,3,2023-11-25 10:58:00,150.0
Cordless Screwdrivers,1,4,3,1,1,2018-07-18 19:44:00,100.0
Cordless Vacuums,1,2,1,1,2,2022-02-08 21:01:00,200.0
Cordless Impact Drivers,1,5,2,3,2,2017-12-13 20:59:00,66.7
Cordless Tool Batteries,4,70,44,26,18,2024-01-21 16:46:00,69.2
12V Cordless Tool Batteries,1,9,6,3,2,2018-09-18 16:42:00,66.7
18V Cordless Tool Batteries,1,36,18,18,10,2024-01-21 16:46:00,55.6
20V Cordless Tool Batteries,1,15,10,5,6,2021-10-09 11:29:00,120.0
Cordless Hammer Drills,1,3,0,3,6,2023-11-28 20:44:00,200.0
Cordless Grinders,1,1,0,1,1,2023-01-11 20:27:00,100.0
Cordless Hedge Trimmers,1,3,1,2,2,2023-11-25 10:58:00,100.0
Cordless Jigsaws,1,2,0,2,0,,0.0
Grinders,4,26,10,16,11,2024-01-25 19:31:00,68.8
Bench Grinders,1,6,1,5,3,2023-04-26 18:54:00,60.0
Die Grinders,1,1,0,1,1,2023-11-25 11:57:00,100.0
Angle Grinders,1,13,7,6,7,2024-01-25 19:31:00,116.7
Lathes,1,4,1,3,1,2016-05-11 19:01:00,33.3
Power Sharpeners,2,1,0,1,1,2017-05-20 11:13:00,100.0
Joiners,4,2,1,1,2,2018-09-16 17:39:00,200.0
Biscuit Joiners,1,2,1,1,2,2018-09-16 17:39:00,200.0
Power Tool Accessories,1,4,0,4,4,2022-06-29 18:37:00,100.0
Air & Pneumatic Tools,17,50,20,30,17,2024-01-21 16:24:00,56.7
Compressors,1,10,2,8,6,2022-09-04 19:00:00,75.0
Air Tool Sets,1,1,0,1,1,2020-07-25 12:06:00,100.0
Jacks,3,14,4,10,3,2021-04-10 10:09:00,30.0
House Jack,1,7,1,6,2,2016-06-18 11:38:00,33.3
Air Brad Nailers,1,6,2,4,4,2024-01-21 16:24:00,100.0
Air Finish Nailers,1,3,1,2,2,2017-02-25 09:49:00,100.0
Air Staplers,1,3,2,1,1,2017-09-13 18:36:00,100.0
Air Wrenches,1,1,1,0,0,,
Air Sanders,1,1,0,1,1,2023-12-23 12:11:00,100.0
Bike Tools,9,98,25,73,11,2024-01-03 19:34:00,15.1
Bottom Bracket Tools,1,5,0,5,3,2019-09-15 17:09:00,60.0
"Brakes, Housing & Cable Tools",1,1,0,1,0,,0.0
Drive Train Tools,1,21,10,11,5,2017-05-10 21:06:00,45.5
Wheel Tools,1,39,8,31,8,2022-05-29 17:34:00,25.8
Bike Pressure Gauges,1,1,0,1,0,,0.0
Bike Repair Stands,1,3,1,2,2,2024-01-03 19:34:00,100.0
Propane & Gas Powered Tools,12,7,4,3,3,2023-01-21 12:05:00,100.0
Propane Torch Kit,1,7,4,3,3,2023-01-21 12:05:00,100.0
Meters & Diagnostics,28,33,20,13,11,2024-01-22 19:08:00,84.6
Multimeters,1,15,6,9,9,2024-01-22 19:08:00,100.0
Power Meters,4,2,0,2,2,2024-01-06 11:18:00,100.0
Non-logging Power Meters,1,1,0,1,1,2021-01-09 12:12:00,100.0
Distance Meters,1,1,1,0,1,2019-12-23 18:46:00,inf
Detectors,1,1,0,1,2,2024-01-02 19:04:00,200.0
Tachometers,1,1,1,0,0,,
Wheelbarrows & Wagons,3,4,2,2,3,2024-01-15 19:55:00,150.0
Wheelbarrow,1,4,2,2,3,2024-01-15 19:55:00,150.0
Safety Equipment,12,64,35,29,10,2024-01-13 10:32:00,34.5
Work Gloves,1,20,11,9,9,2017-05-17 19:12:00,100.0
Protective Goggles,1,10,5,5,4,2024-01-13 10:32:00,80.0
Respirators,1,5,0,5,3,2022-09-03 12:14:00,60.0
Safety Glasses,1,15,9,6,2,2019-05-11 10:40:00,33.3
Hearing Protection,3,3,1,2,2,2021-06-19 09:58:00,100.0
Ear Muffs,1,3,1,2,2,2021-06-19 09:58:00,100.0
Automotive Tools,10,81,30,51,46,2024-01-25 11:12:00,90.2
Jack Stands,1,15,4,11,14,2024-01-14 11:19:00,127.3
Automotive Jacks,1,9,3,6,7,2024-01-08 21:01:00,116.7
Garage Jacks,1,1,0,1,2,2022-10-15 11:54:00,200.0
Automotive Ramps,1,3,0,3,3,2024-01-08 21:01:00,100.0
Automotive Pressure Gauges,1,3,1,2,1,2018-11-03 11:44:00,50.0
Fencing Tools,8,7,3,4,3,2017-05-31 20:22:00,75.0
Post Hole Digger,1,7,3,4,3,2017-05-31 20:22:00,75.0
Garden Tools,14,89,26,63,16,2024-01-25 19:31:00,25.4
Weeders,3,14,1,13,3,2017-06-24 09:46:00,23.1
Hoes,1,22,10,12,8,2024-01-25 19:31:00,66.7
Seeders,5,3,0,3,1,2022-03-26 11:30:00,33.3
Hand Seeders,1,3,0,3,1,2022-03-26 11:30:00,33.3
Hand Tillers,1,1,0,1,1,2017-03-25 10:45:00,100.0
Planting Templates,2,1,1,0,1,2019-03-03 18:27:00,inf
Garden Hoses,1,28,12,16,4,2023-08-22 20:56:00,25.0
Garden Gloves,1,7,0,7,4,2024-01-25 19:31:00,57.1
Farm Tools,6,1,0,1,0,,0.0
Tractor Accessories,13,2,0,2,1,2016-07-13 18:53:00,50.0
Manure Spreaders,1,2,0,2,1,2016-07-13 18:53:00,50.0
Tree & Orchard Care Tools,12,40,27,13,8,2022-06-29 20:50:00,61.5
Chainsaws,7,7,6,1,4,2022-11-27 16:48:00,400.0
Pruning Saw,1,3,0,3,1,2017-12-30 10:59:00,33.3
Pruning Shears,1,30,21,9,4,2019-06-09 18:24:00,44.4
Orchard Sprayers,3,1,0,1,0,,0.0
Hand Pump Orchard Sprayers,1,1,0,1,0,,0.0
Plumbing Tools,1,30,11,19,3,2024-01-23 21:01:00,15.8
Heavy Equipment,9,2,1,1,2,2019-01-12 09:47:00,200.0
Earthmoving Equipment,7,2,1,1,2,2019-01-12 09:47:00,200.0
Welding,9,3,1,2,2,2018-11-14 19:25:00,100.0
Welders,1,3,1,2,2,2018-11-14 19:25:00,100.0
Welding Safety Equipment,10,4,3,1,2,2018-07-22 17:56:00,200.0
Welding Gloves,1,1,1,0,1,2022-01-16 18:36:00,inf
Welding Helmets,1,3,2,1,2,2018-07-22 17:56:00,200.0
MIG Welding,5,1,0,1,1,2021-04-27 20:47:00,100.0
MIG Welders,1,1,0,1,1,2021-04-27 20:47:00,100.0
"Chains, Ropes, and Straps",5,47,24,23,4,2021-12-08 18:44:00,17.4
Chains,1,2,0,2,1,2019-12-21 11:50:00,50.0
Bungee Cords,1,18,6,12,4,2021-12-08 18:44:00,33.3
Ropes,1,26,18,8,1,2017-12-13 18:12:00,12.5
Flooring Tools,4,21,6,15,5,2022-08-10 18:25:00,33.3
Carpet Tools,4,10,3,7,4,2023-05-07 17:34:00,57.1
Carpet Roller,1,2,0,2,1,2018-04-28 10:38:00,50.0
Tile Cutters,3,13,5,8,6,2024-01-09 19:09:00,75.0
Hand Tile Cutter,1,7,4,3,5,2024-01-09 19:09:00,166.7
Tile Nipper,1,3,0,3,1,2017-09-13 17:12:00,33.3
Laminate Flooring Cutters,1,1,0,1,1,2022-01-04 18:28:00,100.0
Tool Kits,1,3,0,3,0,,0.0
Kitchen & Dining,31,112,45,67,16,2024-01-16 18:27:00,23.9
"Canning, Preserving & Homebrew",2,14,7,7,3,2019-07-13 11:16:00,42.9
Appliances,1,10,6,4,2,2017-09-30 11:50:00,50.0
Cook's Tools,1,10,4,6,2,2020-08-29 12:01:00,33.3
Other Kitchen & Serving,1,13,6,7,2,2017-09-13 16:12:00,28.6
Food Service Displays,1,1,0,1,1,2018-11-20 18:51:00,100.0
Glassware & Drinkware,6,14,5,9,4,2019-07-10 19:17:00,44.4
Glassware,1,1,1,0,1,2018-02-17 12:04:00,inf
Mugs,3,1,0,1,0,,0.0
Ceramic Mugs,1,1,0,1,0,,0.0
Food Storage,1,13,5,8,4,2019-07-10 19:17:00,50.0
Kitchen Gadgets,1,4,2,2,5,2024-01-16 18:27:00,250.0
Plates & Bowls,3,2,2,0,1,2022-08-31 19:53:00,inf
Plates,5,1,0,1,2,2024-01-08 21:51:00,200.0
Dinner Plates,1,1,0,1,2,2024-01-08 21:51:00,200.0
Small Appliances,8,34,11,23,6,2022-12-28 18:22:00,26.1
Grain Mills,1,2,0,2,2,2022-12-18 18:08:00,100.0
Ice Cream Makers,1,5,2,3,2,2017-08-02 21:07:00,66.7
Bread Makers,1,1,0,1,1,2019-01-20 18:24:00,100.0
Instant Pots,1,1,0,1,1,2022-02-23 18:28:00,100.0
Slow Cookers,1,5,2,3,2,2018-03-28 17:47:00,66.7
Pots & Pans,1,1,1,0,0,,
Induction Cooking,3,4,1,3,1,2018-09-01 09:29:00,33.3
Induction Cooktops,1,4,1,3,1,2018-09-01 09:29:00,33.3
Cutting Boards,1,1,0,1,0,,0.0
Kitchen Tools,1,2,0,2,0,,0.0
Kitchen Appliances,1,2,0,2,2,2023-10-11 18:30:00,100.0
Books & Media,14,13,6,7,3,2022-07-31 18:12:00,42.9
Books,10,9,2,7,3,2022-07-31 18:12:00,42.9
Magazines,1,1,1,0,0,,
DVD,1,2,2,0,0,,
CD-ROM,1,1,1,0,0,,
Electronics,35,28,17,11,7,2024-01-14 14:36:00,63.6
Lights,2,16,7,9,13,2024-01-18 18:17:00,144.4
Work Lights,4,27,12,15,17,2024-01-18 18:17:00,113.3
Clamp Lights,1,3,0,3,2,2023-01-24 19:34:00,66.7
Hanging Lights,1,11,7,4,4,2022-10-23 16:52:00,100.0
Other Mobile Devices,4,4,0,4,0,,0.0
iPods,1,4,0,4,0,,0.0
Network Equipment,6,2,1,1,0,,0.0
Network Switches,1,1,1,0,0,,
Network Accessories,2,5,0,5,0,,0.0
Network Cables,1,5,0,5,0,,0.0
Video Gaming,4,3,2,1,0,,0.0
Controllers,1,1,0,1,0,,0.0
Video Game Accessories,1,2,2,0,0,,
Computers,15,32,17,15,6,2022-08-09 19:37:00,40.0
Laptop Computers,4,12,6,6,6,2023-09-09 09:52:00,100.0
Windows Laptops,1,6,3,3,5,2023-09-09 09:52:00,166.7
Computer Accessories,5,2,2,0,1,2021-10-05 19:40:00,inf
Keyboards & Mice,6,4,4,0,1,2021-10-05 19:40:00,inf
Wired Keyboards,1,1,1,0,0,,
Wired Mice,1,1,1,0,1,2022-06-22 20:02:00,inf
Monitors and Displays,1,7,4,3,2,2017-12-06 15:57:00,66.7
Computer Power Adapters,1,8,4,4,1,2021-07-24 09:37:00,25.0
Computer Cables,9,22,9,13,4,2022-08-10 19:55:00,30.8
USB-A Cables,1,7,6,1,2,2021-10-05 19:40:00,200.0
USB-C Cables,1,9,1,8,1,2022-08-09 19:37:00,12.5
Displayport Cables,1,2,0,2,1,2022-08-10 19:55:00,50.0
USB Chargers,1,5,2,3,0,,0.0
Printers & Scanners,6,11,5,6,4,2023-01-24 19:34:00,66.7
3D Printers,1,7,3,4,3,2023-01-24 19:34:00,75.0
Printer Accessories,1,1,1,0,1,2022-08-03 18:54:00,inf
Label Makers,1,1,0,1,1,2022-06-28 20:56:00,100.0
Laser Printers,4,1,0,1,0,,0.0
Black & White Laser Printers,1,1,0,1,0,,0.0
Inkjet Printers,3,2,1,1,1,2018-10-13 10:13:00,100.0
Multifunction Inkjet Printers,1,1,1,0,0,,
Video & Photography,22,17,6,11,3,2017-10-22 17:22:00,27.3
Projectors,6,2,2,0,2,2017-07-29 11:26:00,inf
TVs,1,2,0,2,0,,0.0
Video Cables,6,3,1,2,1,2022-08-10 19:55:00,50.0
HDMI Cables,1,3,1,2,1,2022-08-10 19:55:00,50.0
Video Adapters,1,3,0,3,1,2022-05-17 21:10:00,33.3
Camera Equipment,3,1,0,1,1,2022-12-18 17:18:00,100.0
Camera Lighting Equipment,1,1,0,1,1,2022-12-18 17:18:00,100.0
Projector Screens,1,3,0,3,1,2016-09-04 18:55:00,33.3
Camera Tripods,1,4,1,3,1,2017-09-06 17:35:00,33.3
Video Switchers,1,1,1,0,0,,
Video Players & Recorders,4,2,1,1,2,2022-10-02 18:18:00,200.0
Blu-ray Players,1,1,0,1,1,2022-08-30 19:21:00,100.0
Sensors,5,1,1,0,0,,
Communications Devices,8,3,0,3,1,2021-05-04 18:13:00,33.3
Radio Base Stations,1,1,0,1,0,,0.0
Telephones,4,2,0,2,1,2021-05-04 18:13:00,50.0
Lighting,14,1,0,1,0,,0.0
Smartphones,3,4,2,2,1,2022-05-15 19:03:00,50.0
iPhones,1,4,2,2,1,2022-05-15 19:03:00,50.0
Other Electronic Devices,1,1,1,0,0,,
Shredders,1,1,0,1,3,2024-01-14 14:36:00,300.0
Barcode & RFID Scanners,3,3,1,2,0,,0.0
Barcode Scanners,1,3,1,2,0,,0.0
Data Storage Devices,6,8,4,4,4,2024-01-24 19:33:00,100.0
USB Flash Drives & Memory Cards,1,7,4,3,4,2024-01-24 19:33:00,133.3
VR Gear,1,2,1,1,1,2021-04-03 09:19:00,100.0
Power,5,15,5,10,2,2022-02-08 21:01:00,20.0
Power Adapters,3,8,6,2,1,2022-01-15 15:23:00,50.0
AC Adapters,1,5,3,2,1,2022-01-15 15:23:00,50.0
Power Strips & Surge Protectors,3,16,5,11,6,2020-03-09 19:18:00,54.5
Power Strips,1,15,5,10,5,2020-03-09 19:18:00,50.0
Surge Protectors,1,1,0,1,1,2020-03-09 19:18:00,100.0
Power Plug & Socket Adapters,1,8,0,8,1,2018-05-20 16:27:00,12.5
Audio,23,10,2,8,9,2023-01-03 18:57:00,112.5
Microphones,7,2,0,2,2,2021-09-29 19:37:00,100.0
Speakers & Amplifiers,3,1,1,0,0,,
Audio Accessories,4,1,1,0,0,,
Audio Cables,9,1,1,0,0,,
Audio Recording Gear,4,1,1,0,1,2019-05-15 20:21:00,inf
Audio Mixers,4,1,0,1,1,2019-08-31 11:39:00,100.0
Public Address Systems,1,3,0,3,6,2022-12-10 12:07:00,200.0
Microphone Stands,1,1,0,1,0,,0.0
Microcontroller Kits,1,1,0,1,0,,0.0
Sports & Outdoors,42,69,23,46,15,2024-01-22 18:27:00,32.6
Snowboards,1,1,0,1,0,,0.0
Goggles,1,3,2,1,3,2024-01-22 18:27:00,300.0
Boats & Rafts,1,1,0,1,1,2022-07-30 10:22:00,100.0
Skates,1,1,1,0,0,,
Camping & Hiking,17,24,11,13,9,2022-06-08 21:42:00,69.2
Tents,3,5,1,4,3,2022-04-13 18:53:00,75.0
Hiking Backpacks,3,3,2,1,2,2019-03-09 09:18:00,200.0
Camp Stoves,5,4,3,1,1,2016-06-07 20:58:00,100.0
Two Burner Camp Stoves,1,1,1,0,1,2016-06-07 20:58:00,inf
Canister Stoves,1,1,0,1,0,,0.0
Liquid Fuel Stoves,1,1,1,0,1,2021-05-29 10:03:00,inf
Water Bottles,1,1,0,1,1,2017-09-06 17:35:00,100.0
Sleeping Bags,2,1,1,0,1,2017-06-21 20:04:00,inf
Sleeping Pads,3,7,3,4,5,2018-08-21 16:29:00,125.0
Foam Sleeping Pads,1,1,0,1,1,2018-06-08 13:28:00,100.0
Air Mattress Sleeping Pads,1,2,2,0,1,2017-07-19 19:57:00,inf
Camping Tarps,1,3,3,0,2,2018-04-21 09:53:00,inf
Camping & Hiking Storage,2,1,1,0,1,2022-04-23 12:54:00,inf
Camping Furniture,4,6,1,5,3,2020-08-22 12:06:00,60.0
Camping Chairs,1,6,1,5,3,2020-08-22 12:06:00,60.0
Telescopes & Binoculars,4,6,4,2,2,2016-09-18 18:39:00,100.0
Telescopes,7,4,3,1,2,2016-09-18 18:39:00,200.0
Sports & Outdoor Accessories,4,10,5,5,3,2024-01-10 20:28:00,60.0
Headlamps,1,3,2,1,2,2017-10-29 18:10:00,200.0
Winter Sports,9,3,0,3,2,2021-02-13 10:33:00,66.7
Climbing & Mountaineering,13,8,1,7,2,2018-06-20 20:38:00,28.6
Climbing Harnesses,1,1,0,1,0,,0.0
Outdoors Safety,9,3,1,2,0,,0.0
Water Safety,4,3,0,3,1,2020-09-05 12:11:00,33.3
Personal Flotation Devices,4,3,0,3,1,2020-09-05 12:11:00,33.3
Bicycle Accessories,7,9,2,7,2,2022-11-06 16:22:00,28.6
Bicycle Trailers,1,2,1,1,1,2019-06-26 21:50:00,100.0
Rafts,1,8,1,7,4,2020-02-22 13:09:00,57.1
Balls,1,3,0,3,2,2024-01-10 20:28:00,66.7
Water Sports,8,4,0,4,1,2019-09-01 18:00:00,25.0
Kayaking Gear,4,1,0,1,0,,0.0
Wetsuits,1,3,0,3,1,2019-09-01 18:00:00,33.3
Outdoor Recreation,7,1,0,1,1,2017-08-05 10:05:00,100.0
BBQ Grills,1,1,0,1,1,2017-08-05 10:05:00,100.0
Marine & Fishing,8,17,10,7,4,2022-03-13 16:14:00,57.1
Traps & Pots,3,2,0,2,1,2019-05-08 20:52:00,50.0
Fishing,6,1,0,1,0,,0.0
Fishing Rods,1,1,0,1,0,,0.0
Baseball Equipment,5,1,0,1,0,,0.0
Tally Counters,1,1,0,1,0,,0.0
Music,13,3,1,2,0,,0.0
Guitars,11,2,1,1,0,,0.0
Musical Instrument Accessories,10,1,0,1,0,,0.0
Vehicles & Trailers,16,9,2,7,1,2018-04-08 17:39:00,14.3
Cars,2,1,0,1,0,,0.0
Hitches & Towing Accessories,3,27,9,18,9,2022-11-12 12:04:00,50.0
Ratchet Straps,1,24,8,16,9,2022-11-12 12:04:00,56.2
Clothing,21,4,3,1,1,2018-05-16 20:09:00,100.0
Footwear,7,1,0,1,0,,0.0
Boots,2,1,0,1,0,,0.0
Jewelry & Accessories,8,1,1,0,1,2018-05-16 20:09:00,inf
Personal Protective Equipment,5,2,1,1,0,,0.0
Personal Protective Head Gear,3,3,0,3,0,,0.0
Helmets,1,1,0,1,0,,0.0
Hard Hats,1,2,0,2,0,,0.0
Eye Protection,1,1,1,0,0,,
Headwear,5,1,0,1,1,2021-12-10 20:33:00,100.0
Hats,3,1,0,1,1,2021-12-10 20:33:00,100.0
Bags,6,1,1,0,0,,
Handbags,3,2,2,0,0,,
Totes,1,1,1,0,0,,
Toys & Games,8,12,3,9,2,2019-07-10 20:55:00,22.2
Games,6,26,9,17,4,2022-07-30 09:14:00,23.5
Board Games,1,22,8,14,4,2022-07-30 09:14:00,28.6
Other Games,1,2,1,1,2,2017-06-10 11:45:00,200.0
Toys,1,3,0,3,0,,0.0
Activities,1,2,1,1,0,,0.0
Furniture & Spaces,22,35,16,19,7,2023-10-07 10:14:00,36.8
Offices,1,2,1,1,2,2023-01-03 18:57:00,200.0
Gardens,1,2,1,1,1,2018-06-24 19:03:00,100.0
Furniture,8,22,13,9,7,2024-01-15 19:55:00,77.8
Chairs,3,43,3,40,42,2018-11-17 10:12:00,105.0
Folding Chairs,1,42,2,40,42,2018-11-17 10:12:00,105.0
Tables,2,18,6,12,5,2017-05-10 19:52:00,41.7
Folding Tables,1,12,3,9,5,2018-06-02 10:17:00,55.6
Storage Furniture,1,1,1,0,1,2021-03-30 20:10:00,inf
Miscellaneous Furniture,1,14,8,6,7,2024-01-15 19:55:00,116.7
Keys,1,1,0,1,0,,0.0
Storage & Organization,8,30,16,14,5,2023-10-07 10:14:00,35.7
Storage Bins,2,6,5,1,2,2021-03-23 20:06:00,200.0
Waste & Trash Baskets,1,1,1,0,1,2021-01-23 09:21:00,inf
Laundry Organization,6,5,1,4,3,2024-01-02 19:51:00,75.0
Ironing Boards,1,1,0,1,0,,0.0
Steam Irons,1,4,1,3,3,2024-01-02 19:51:00,100.0
Storage Lockers,1,1,0,1,0,,0.0
Moving Supplies,6,7,2,5,4,2018-03-17 10:49:00,80.0
Moving Blankets,1,5,2,3,4,2018-03-17 10:49:00,133.3
Moving Carts,1,1,0,1,1,2017-09-16 11:45:00,100.0
Beds & Cots,4,1,0,1,0,,0.0
Beds,1,1,0,1,0,,0.0
Cleaning,2,3,1,2,1,2022-04-12 19:08:00,50.0
Brooms & Mops,5,13,5,8,2,2019-02-16 10:50:00,25.0
Push Brooms,1,8,2,6,2,2019-02-16 10:50:00,33.3
House Broom,1,1,1,0,1,2016-10-29 10:33:00,inf
Brooms,1,3,2,1,1,2020-09-26 11:08:00,100.0
Stage & Screen,9,1,1,0,0,,
Other Props,1,1,1,0,0,,
Bedding,5,1,0,1,0,,0.0
Pillows,1,1,0,1,0,,0.0
Pets,4,3,2,1,1,2017-03-13 21:22:00,100.0
Pet Carriers,1,3,2,1,1,2017-03-13 21:22:00,100.0
Yardshares,1,1,0,1,0,,0.0
Rooms,1,1,0,1,0,,0.0
Medical Equipment,22,2,1,1,1,2019-12-21 11:50:00,100.0
Medical Diagnostics,5,5,2,3,2,2022-12-13 21:13:00,66.7
Thermometers,1,5,2,3,2,2022-12-13 21:13:00,66.7
Walking Aids,8,8,2,6,2,2021-03-06 11:01:00,33.3
Walkers,1,1,0,1,0,,0.0
Knee Wheelers & Scooters,1,4,2,2,2,2021-03-06 11:01:00,100.0
Rollators & Rolling Walkers,1,1,0,1,1,2022-06-23 19:14:00,100.0
Canes,1,1,0,1,0,,0.0
Crutches,1,1,0,1,0,,0.0
Bathroom Safety,5,2,0,2,0,,0.0
Shower Chairs & Benches,4,1,0,1,0,,0.0
Bathroom Grab Bars,1,1,0,1,0,,0.0
Medical Braces,8,2,2,0,0,,
Knee Braces,1,1,1,0,0,,
Walking Boots & Braces,1,1,1,0,0,,
Medical Trauma Kit,3,1,0,1,1,2019-12-21 11:50:00,100.0
Art,8,56,35,21,9,2024-01-25 19:31:00,42.9
Fiber Arts,1,20,14,6,3,2017-09-16 12:15:00,50.0
Ceramic & Glass Arts,1,17,10,7,1,2017-11-15 17:56:00,14.3
Wood & Metal Arts,1,3,0,3,3,2024-01-23 19:47:00,100.0
Materials,9,8,5,3,4,2024-01-25 19:31:00,133.3
Wood,1,1,1,0,1,2016-07-09 11:56:00,inf
Science & Engineering,8,2,1,1,1,2021-08-11 19:12:00,100.0
Research Equipment,1,1,0,1,0,,0.0
Lab Instruments & Equipment,8,3,2,1,1,2021-02-27 11:30:00,100.0
Microscopes,1,3,2,1,1,2021-02-27 11:30:00,100.0
General Measurement,1,1,1,0,1,2021-08-11 19:12:00,inf
Hobbies & Crafts,10,95,48,47,32,2024-01-16 19:15:00,68.1
Sewing Machines,1,18,9,9,13,2024-01-16 19:15:00,144.4
Hobby & Craft Kits,1,6,2,4,5,2023-09-10 18:45:00,125.0
Scissors,1,25,9,16,4,2021-12-05 16:22:00,25.0
Electrical Equipment,9,1,0,1,1,2023-12-21 19:02:00,100.0
Party & Events,9,3,1,2,1,2022-05-31 20:58:00,50.0
Recycling & Waste Management,5,3,0,3,1,2022-05-31 20:58:00,33.3
Waste & Trash Bins,1,1,0,1,0,,0.0
Beverage Service Equipment,8,2,1,1,0,,0.0
Large Ice Chest / Coolers,1,1,0,1,0,,0.0
Portable Heating & Cooling,3,3,0,3,4,2024-01-09 18:13:00,133.3
Fan Heaters,1,3,0,3,4,2024-01-09 18:13:00,133.3
Office & Industrial,3,2,1,1,1,2022-11-22 19:53:00,100.0
Cubicles,1,1,1,0,1,2022-11-22 19:53:00,inf
More,2,3,1,2,0,,0.0
Other,1,3,1,2,0,,0.0
