Item Type,Types Of Items,Item Count,Disabled Item Count,Active Item Count,Max Checked Out,Max Checked Out Date,Utilization
Tools,20,184,35,149,23,2022-10-02 17:33:00,15.4
Hand Tools,80,1194,335,859,163,2022-12-28 20:03:00,19.0
Shovels & Digging,10,45,5,40,18,2022-07-17 17:51:00,45.0
Spade Shovel,1,11,2,9,5,2022-12-27 20:19:00,55.6
Square Shovel,1,14,2,12,4,2020-07-11 10:27:00,33.3
Round Point Shovel,1,8,1,7,5,2019-06-01 10:38:00,71.4
Planters Shovel,1,4,0,4,3,2022-06-22 20:24:00,75.0
Snow Shovel,1,7,0,7,5,2019-02-16 10:17:00,71.4
Rakes,11,28,5,23,7,2018-05-05 11:37:00,30.4
Metal Garden Rake,1,9,0,9,4,2022-10-15 10:29:00,44.4
Hand Rake,1,1,0,1,1,2018-03-14 20:24:00,100.0
Thatching Rake,1,1,0,1,0,,0.0
Leaf Rake,1,2,0,2,2,2021-04-03 11:46:00,100.0
Pruners,5,36,6,30,14,2022-12-28 20:06:00,46.7
Loppers,1,10,3,7,4,2018-06-17 19:57:00,57.1
Hand Pruner,1,21,3,18,10,2022-09-18 18:20:00,55.6
Telescopic Pruner,1,2,0,2,3,2022-12-14 13:38:00,150.0
Fruit Pickers,1,3,0,3,3,2017-09-02 10:24:00,100.0
Axes,6,17,6,11,10,2022-12-10 11:37:00,90.9
Hatchet,1,5,3,2,3,2021-06-12 09:56:00,150.0
Wedge,1,1,0,1,2,2022-02-09 20:47:00,200.0
Hand Axe,1,6,2,4,3,2022-10-08 09:12:00,75.0
Maul,1,1,0,1,2,2022-05-07 09:34:00,200.0
Saws,13,164,49,115,42,2022-12-18 17:42:00,36.5
Hand Miter Saws,1,14,3,11,5,2022-12-11 16:46:00,45.5
Bow Saws,1,4,0,4,5,2022-12-03 10:53:00,125.0
Hack Saws,1,25,11,14,7,2022-07-16 09:03:00,50.0
Coping Saw,1,10,1,9,6,2022-12-18 17:00:00,66.7
Back Saws,1,15,4,11,3,2018-01-07 16:53:00,27.3
Crosscut Saws,1,1,1,0,0,,
Drywall Saws,1,2,0,2,1,2018-06-20 20:45:00,50.0
Hole Saws,1,4,0,4,3,2018-08-19 17:49:00,75.0
Hole Saw Kits,1,2,0,2,2,2022-06-21 18:46:00,100.0
Key Hole Saws,1,35,12,23,4,2019-07-01 19:26:00,17.4
Wrenches,12,292,70,222,23,2022-12-28 18:09:00,10.4
Torque Wrench,1,6,0,6,4,2022-08-03 18:04:00,66.7
Pipe Wrenches,1,34,7,27,6,2017-02-01 19:01:00,22.2
Basin Wrench,1,10,1,9,2,2018-07-10 17:00:00,22.2
Belt Strap Wrench,1,11,5,6,2,2021-06-08 20:49:00,33.3
Chain Wrench,1,3,0,3,2,2017-05-10 19:07:00,66.7
Adjustable Wrench,1,48,13,35,10,2022-11-23 19:50:00,28.6
Lock Nut Wrench,1,5,0,5,1,2017-10-22 17:14:00,20.0
Open End Wrench,1,66,27,39,3,2018-05-16 19:23:00,7.7
Spanner Wrenches,1,1,0,1,0,,0.0
Wrench Sets,10,402,156,246,40,2022-11-30 19:21:00,16.3
Socket Sets,1,223,118,105,27,2022-11-30 19:21:00,25.7
Allen Wrench Sets,1,45,16,29,9,2022-11-13 17:16:00,31.0
Spark Plug Wrench Set,1,4,0,4,1,2020-01-11 12:01:00,25.0
Box Wrench Sets,1,20,5,15,2,2021-04-13 20:49:00,13.3
Ratcheting Wrench Sets,1,3,0,3,1,2018-09-04 18:16:00,33.3
Open End Wrench Sets,1,1,0,1,0,,0.0
Combination Wrench Sets,1,104,17,87,7,2021-09-01 20:09:00,8.0
Measuring & Layout Tools,15,220,64,156,67,2022-12-28 19:00:00,42.9
Levels,1,52,13,39,28,2022-12-28 19:00:00,71.8
Tape Measures,1,41,25,16,4,2022-08-20 11:08:00,25.0
Calipers,1,7,1,6,2,2018-09-12 19:56:00,33.3
Chalklines,1,10,1,9,1,2018-01-27 11:08:00,11.1
Squares,1,36,5,31,10,2022-12-19 19:35:00,32.3
Yardsticks,1,6,0,6,2,2021-08-31 20:43:00,33.3
Rulers,1,15,1,14,3,2019-06-02 19:03:00,21.4
Stud finder,1,22,6,16,19,2022-12-18 16:28:00,118.8
Plumb Bob,1,1,0,1,0,,0.0
T-Bevels,1,2,1,1,1,2019-09-04 19:31:00,100.0
Contour Gauges,1,6,5,1,2,2022-08-02 18:22:00,200.0
Compasses (drawing),1,4,1,3,1,2017-07-23 17:41:00,33.3
Marking,1,4,0,4,0,,0.0
Scrapers,5,89,10,79,12,2017-07-29 09:46:00,15.2
Paint Scraper,1,19,1,18,3,2019-09-16 18:37:00,16.7
Sidewalk Ice Scraper,1,1,0,1,1,2020-08-29 11:53:00,100.0
Planes,1,27,9,18,6,2019-06-02 19:03:00,33.3
Chisels & Gouges,4,110,23,87,32,2022-12-14 13:38:00,36.8
Cement Chisel,1,5,1,4,2,2017-07-29 09:46:00,50.0
Cold Chisel,1,6,2,4,1,2016-07-02 11:41:00,25.0
Wood Chisel,1,23,2,21,9,2022-12-06 21:22:00,42.9
Drills,1,10,3,7,2,2019-10-12 11:04:00,28.6
"Bits, Drivers and Accessories",2,89,25,64,33,2022-12-27 18:55:00,51.6
Drill Bits,1,54,10,44,29,2022-12-27 18:55:00,65.9
Screwdrivers,6,488,113,375,43,2022-12-27 19:44:00,11.5
Flat Screwdrivers,1,231,59,172,17,2022-12-10 11:37:00,9.9
Phillips Screwdrivers,1,164,42,122,15,2022-12-27 19:44:00,12.3
Torx Screwdrivers,1,24,0,24,7,2021-11-30 18:26:00,29.2
Screwdriver Sets,1,24,4,20,4,2021-09-29 19:37:00,20.0
Robertson Screwdrivers,1,7,0,7,2,2018-08-14 16:38:00,28.6
Clamps & Brackets,13,266,74,192,60,2022-07-24 16:53:00,31.2
C-Clamps,1,86,24,62,21,2022-07-31 16:45:00,33.9
Bar Clamps,1,55,14,41,22,2022-12-18 17:18:00,53.7
Corner Clamp,1,14,6,8,11,2018-01-27 12:14:00,137.5
Quick Grip Clamp,1,52,11,41,18,2020-08-08 13:02:00,43.9
Wood Clamp,1,3,1,2,0,,0.0
Drill Press Clamps,1,1,0,1,1,2017-06-18 16:55:00,100.0
Hand Clamps,1,23,14,9,6,2017-04-15 10:18:00,66.7
Vises,1,12,0,12,4,2022-11-19 10:04:00,33.3
Pipe Clamps,1,6,1,5,1,2022-07-03 16:09:00,20.0
Web Clamps,1,5,0,5,2,2022-10-11 20:36:00,40.0
Saw Blades,4,9,2,7,3,2019-10-07 18:45:00,42.9
Table Saw Blades,1,1,0,1,1,2019-07-20 10:58:00,100.0
Dado Saw Blades,1,5,0,5,1,2018-06-06 20:55:00,20.0
Hammers & Mallets,11,132,63,69,35,2022-12-27 20:19:00,50.7
Rubber Mallets,1,15,4,11,8,2022-12-20 20:38:00,72.7
Sledgehammers,1,8,0,8,6,2022-12-27 20:19:00,75.0
Ball Peen Hammers,1,5,1,4,2,2017-10-29 17:31:00,50.0
Claw Hammers,1,90,56,34,20,2022-12-27 19:44:00,58.8
Framing Hammers,1,1,0,1,1,2016-11-30 19:25:00,100.0
Tack Hammers,1,3,0,3,2,2022-12-27 18:55:00,66.7
Ladders,10,16,4,12,6,2022-05-29 18:12:00,50.0
Step Ladders,1,5,2,3,4,2022-11-02 20:25:00,133.3
Multi Ladder,1,2,0,2,1,2022-02-20 18:52:00,50.0
Knives,5,94,40,54,8,2022-08-27 10:50:00,14.8
Linoleum Knives,1,10,2,8,1,2017-02-22 19:47:00,12.5
Putty Knife,1,17,6,11,4,2017-11-19 18:04:00,36.4
Utility Knives,1,50,23,27,5,2019-07-01 19:26:00,18.5
"Pliers, Cutters, and Snips",9,208,59,149,27,2022-12-11 18:28:00,18.1
Slip Joint Pliers,1,41,4,37,5,2019-10-26 11:18:00,13.5
Wire Cutters,1,35,5,30,9,2021-11-06 11:27:00,30.0
Needle Nose Pliers,1,43,17,26,6,2018-08-01 19:43:00,23.1
Lineman Plier,1,3,1,2,2,2018-05-19 09:57:00,100.0
Locking Pliers,1,4,0,4,1,2017-06-17 10:19:00,25.0
Bolt Cutters,1,7,4,3,4,2020-10-24 09:36:00,133.3
Buckets,1,28,7,21,5,2022-01-22 10:16:00,23.8
Extension Poles,1,5,0,5,4,2021-06-26 10:53:00,80.0
Brushes and Rollers,11,203,37,166,39,2022-12-07 21:01:00,23.5
Sharp Bristle Brushes,1,22,2,20,3,2018-10-20 11:40:00,15.0
Counter Brush,1,4,1,3,1,2017-05-24 19:10:00,33.3
Smoothing Brush,1,1,0,1,0,,0.0
Paint Guide,1,9,2,7,3,2017-06-14 20:23:00,42.9
Paint Roller Frame,1,45,6,39,13,2022-12-04 18:59:00,33.3
Roller Tool,1,3,0,3,2,2017-06-14 20:23:00,66.7
Sanders,1,25,11,14,5,2021-04-03 10:13:00,35.7
Crimpers,1,11,2,9,2,2019-06-22 10:08:00,22.2
Pry Bars & Crowbars,7,47,9,38,21,2022-12-14 13:38:00,55.3
Crowbars,1,15,4,11,5,2017-08-19 12:15:00,45.5
Nail Puller,1,11,0,11,4,2022-10-25 19:00:00,36.4
Pry Bar,1,21,5,16,15,2022-12-11 18:28:00,93.8
Hand Tool Sets,1,8,1,7,1,2019-08-14 19:45:00,14.3
Trimmers,2,8,6,2,2,2018-05-05 10:12:00,100.0
Manual Hedge Trimmers,1,6,4,2,1,2022-09-18 18:20:00,50.0
Misc Hand Tools,1,45,37,8,1,2016-05-22 17:25:00,12.5
Edgers,3,12,1,11,5,2021-04-10 11:32:00,45.5
Manual Lawn Edger,1,7,1,6,5,2021-04-10 11:32:00,83.3
Manual Lawn Edger,1,7,1,6,5,2021-04-10 11:32:00,83.3
Tool Stands & Work Tables,5,31,5,26,12,2022-07-12 18:41:00,46.2
Saw Horses,1,19,5,14,9,2020-11-07 09:37:00,64.3
Table Rollers,1,4,0,4,2,2019-02-16 11:55:00,50.0
Tool Bench Work Mate,1,2,0,2,2,2022-06-29 18:37:00,100.0
Vise Grips,1,11,3,8,5,2022-12-28 18:09:00,62.5
Locks and Security,1,1,0,1,1,2019-03-24 18:49:00,100.0
Tap and Die,1,16,3,13,3,2017-11-26 16:51:00,23.1
Planters,1,4,0,4,1,2017-02-25 11:06:00,25.0
Pitchfork,1,7,4,3,2,2017-08-30 16:03:00,66.7
Hand Truck,1,3,2,1,3,2018-03-28 17:58:00,300.0
Drill Press (hand),1,1,0,1,1,2016-10-12 20:08:00,100.0
Staple Guns,3,30,13,17,10,2022-09-21 18:34:00,58.8
Manual Staple Guns,1,5,0,5,5,2022-07-03 16:19:00,100.0
Tin Snips,1,13,1,12,4,2019-05-12 18:45:00,33.3
Tube Cutters,1,8,0,8,3,2022-04-27 18:52:00,37.5
Pipe Cutters,1,11,1,10,2,2020-08-08 10:48:00,20.0
Lawn Mower,1,7,2,5,5,2022-07-12 18:55:00,100.0
Shears,3,3,1,2,2,2019-05-11 10:40:00,100.0
Metal Shears,1,1,0,1,1,2017-12-16 12:14:00,100.0
Trowels & Floats,9,83,24,59,12,2022-03-13 18:19:00,20.3
Notched Trowel,1,32,13,19,7,2022-03-13 18:19:00,36.8
Trowel,1,15,5,10,3,2021-06-19 11:05:00,30.0
Brick Trowel,1,9,1,8,3,2017-10-14 09:29:00,37.5
Corner Trowel,1,7,1,6,1,2016-07-10 18:22:00,16.7
Tuck Point Trowel,1,1,0,1,2,2022-12-07 21:01:00,200.0
Float,1,12,0,12,3,2019-12-03 18:39:00,25.0
Caulk Guns,1,37,13,24,7,2022-04-24 16:19:00,29.2
Conduit Benders,1,4,1,3,1,2016-11-13 17:55:00,33.3
Machete,2,3,2,1,2,2022-02-09 20:47:00,200.0
Rivet Tools,1,8,1,7,1,2018-03-07 16:56:00,14.3
Squeegees,1,9,2,7,3,2018-05-12 11:02:00,42.9
Dollies,1,24,7,17,11,2022-09-17 10:16:00,64.7
Hex Keys,1,1,0,1,0,,0.0
Mixers & Dispensers,2,1,0,1,1,2020-01-05 18:39:00,100.0
Watering Tools,1,2,0,2,0,,0.0
Cultivators,1,4,1,3,2,2019-03-20 20:42:00,66.7
Testers (hand held),1,2,0,2,2,2022-08-16 21:36:00,100.0
Augers & Drain Openers,3,12,2,10,6,2022-06-18 11:51:00,60.0
Manual Drain Auger,1,5,0,5,3,2022-06-12 18:51:00,60.0
Toilet Auger,1,1,0,1,1,2020-01-05 16:15:00,100.0
"Files, Awls & Punches",7,103,27,76,13,2022-04-23 11:49:00,17.1
Files,1,70,23,47,13,2022-05-01 18:17:00,27.7
Punches,1,17,0,17,4,2022-03-08 19:07:00,23.5
Awl,1,3,1,2,1,2017-05-24 20:56:00,50.0
Rasps,1,12,3,9,1,2017-01-04 19:10:00,11.1
Center Punches,1,1,0,1,1,2019-03-09 12:07:00,100.0
Hoists & Trolleys,2,3,1,2,2,2022-10-23 16:52:00,100.0
Chain Hoist,1,3,1,2,2,2022-10-23 16:52:00,100.0
"Scythes, Sickles & Machetes",4,8,2,6,4,2022-06-29 18:50:00,66.7
Hand Sickle,1,1,0,1,0,,0.0
Scythe,1,4,0,4,2,2018-05-26 10:19:00,50.0
Machete,2,3,2,1,2,2022-02-09 20:47:00,200.0
Sharpeners,2,15,2,13,14,2022-10-22 12:17:00,107.7
Finishing Stones,1,9,0,9,12,2022-10-22 12:17:00,133.3
Drywall Tools,5,41,11,30,7,2017-10-04 21:08:00,23.3
Drywall Tool Sets,1,1,0,1,1,2022-07-16 09:44:00,100.0
Joint Knives,1,5,0,5,2,2020-10-10 11:29:00,40.0
Bucket Scoops,3,17,6,11,3,2019-03-25 18:50:00,27.3
Taping Knives,1,12,1,11,3,2019-03-25 18:50:00,27.3
Electrical Tools,3,62,8,54,8,2022-12-13 21:13:00,14.8
Fish Tapes,1,2,0,2,1,2017-08-13 16:54:00,50.0
Wire Strippers,1,32,3,29,4,2019-06-26 19:17:00,13.8
Plumbing Tools,1,23,10,13,2,2019-01-05 11:15:00,15.4
Nail Sets,1,3,0,3,0,,0.0
Jigs,3,9,4,5,2,2022-09-06 20:10:00,40.0
Pocket Hole Jigs,1,4,2,2,1,2018-03-31 11:35:00,50.0
Dovetail Jigs,1,1,0,1,0,,0.0
Gear Pullers,1,6,0,6,4,2022-04-19 18:45:00,66.7
Hand Air Pumps,1,2,0,2,1,2022-06-08 18:17:00,50.0
Plug Cutters,1,3,0,3,1,2017-01-18 20:20:00,33.3
Paint Can Openers,1,2,0,2,1,2018-03-14 16:15:00,50.0
Cleaning Brushes,4,4,3,1,1,2016-09-14 20:15:00,100.0
Wire Brushes,1,1,0,1,1,2016-09-14 20:15:00,100.0
Woodworking Kits,1,1,0,1,2,2022-12-18 18:15:00,200.0
Pickaxes & Mattocks,5,11,1,10,6,2022-12-27 20:19:00,60.0
Pickaxes,1,7,0,7,4,2022-10-09 18:55:00,57.1
Pick Mattocks,1,3,0,3,2,2019-06-01 09:53:00,66.7
Power Tools,8,34,8,26,18,2022-12-13 21:13:00,69.2
Corded & Plug-in,40,234,79,155,77,2022-12-20 23:19:00,49.7
Power Drills,4,64,23,41,32,2022-12-10 10:42:00,78.0
Power Drill 1/2in,1,2,0,2,2,2022-08-06 10:28:00,100.0
Power Drill 3/8in,1,15,4,11,12,2022-11-29 20:18:00,109.1
Hammer Drills,1,3,1,2,2,2017-06-17 09:26:00,100.0
Power Saws,11,118,39,79,46,2022-12-27 18:55:00,58.2
Circular Saws,2,39,16,23,20,2022-12-19 19:34:00,87.0
Scroller Power Saws,1,5,1,4,1,2016-07-31 17:26:00,25.0
Corded Miter Saws,3,14,7,7,10,2022-12-27 18:55:00,142.9
Compound Miter Saw,1,1,1,0,0,,
Jig Saws,1,41,12,29,15,2022-12-19 19:35:00,51.7
Table Saws,1,10,4,6,3,2020-01-18 11:34:00,50.0
Wet Tile Saws,1,7,0,7,4,2018-05-19 10:20:00,57.1
Band Saws,1,2,0,2,1,2016-10-23 18:18:00,50.0
Corded Trimmers,4,10,4,6,4,2019-09-21 10:49:00,66.7
Electric Hedge Trimmers,1,5,2,3,3,2019-09-11 19:01:00,100.0
Electric Lawn Edger,1,3,2,1,1,2016-09-17 09:36:00,100.0
Electric String Trimmer,1,1,0,1,0,,0.0
Extension Cords,1,64,15,49,27,2022-08-07 18:12:00,55.1
Electric Chippers,1,1,0,1,1,2020-09-26 10:49:00,100.0
Buffers,1,5,1,4,3,2022-11-08 21:03:00,75.0
Testers,4,21,3,18,5,2022-08-20 09:11:00,27.8
Circuit Testers,1,10,3,7,3,2020-08-01 10:17:00,42.9
Voltage Tester,1,9,0,9,5,2022-09-24 11:45:00,55.6
Sanders & Planers,11,81,35,46,41,2022-12-18 18:15:00,89.1
Random Orbit Sander,1,8,4,4,6,2022-12-18 18:15:00,150.0
Finishing Power Sanders,1,14,5,9,7,2022-12-10 10:02:00,77.8
Belt Sanders,1,17,6,11,10,2022-10-22 11:26:00,90.9
Power Planer,1,6,4,2,2,2017-05-14 16:19:00,100.0
Power Sanders,1,33,16,17,17,2022-12-06 18:10:00,100.0
Reciprocating Saw,1,12,4,8,7,2022-11-09 21:00:00,87.5
Soldering & Heat Guns,4,72,20,52,10,2022-12-03 11:35:00,19.2
Soldering Iron,1,41,10,31,6,2019-06-25 20:03:00,19.4
Heat Gun,1,10,3,7,4,2017-04-19 18:33:00,57.1
Hot Glue Gun,1,18,7,11,6,2022-10-29 12:05:00,54.5
Paint Sprayer,1,9,6,3,3,2019-07-15 18:38:00,100.0
Electric Dehydrators,1,4,1,3,2,2017-05-31 20:00:00,66.7
Routers,1,13,7,6,5,2019-10-12 09:32:00,83.3
Rotary Tools,3,27,15,12,10,2022-12-18 16:13:00,83.3
Dremel Multi Pro,1,16,10,6,6,2022-12-13 17:58:00,100.0
Roto Zip,1,5,2,3,1,2018-01-07 16:58:00,33.3
Drill Press (power),1,7,4,3,2,2017-06-24 11:08:00,66.7
Pressure Washers,2,8,5,3,6,2022-12-13 21:13:00,200.0
Pressure Washer Attachments,1,1,0,1,2,2022-12-13 21:13:00,200.0
Electric Air Pumps,1,2,0,2,1,2022-07-24 16:28:00,50.0
Chargers,3,34,16,18,7,2021-09-04 09:28:00,38.9
12v Battery Chargers,1,1,0,1,0,,0.0
Rechargeable Battery Charger,1,17,7,10,5,2022-10-15 10:29:00,50.0
Electric Leaf Blower,1,4,0,4,3,2021-07-13 19:08:00,75.0
Engraver,1,6,2,4,2,2017-07-22 11:22:00,50.0
Electric Pumps,3,3,0,3,1,2019-11-16 09:38:00,33.3
Submersible Pump,1,2,0,2,1,2019-11-16 09:38:00,50.0
Electric Mixers & Dispensers,3,8,1,7,2,2020-03-07 13:30:00,28.6
Electric Concrete Stirrers,1,3,1,2,2,2022-09-27 20:01:00,100.0
Paint Mixers & Stirrers,1,5,0,5,2,2022-01-22 10:16:00,40.0
Electric Augers & Drain Openers,1,1,0,1,1,2020-10-17 09:26:00,100.0
Vacuum Cleaners,4,31,7,24,12,2022-12-18 16:27:00,50.0
Wet-Dry Vac,1,22,5,17,11,2022-07-30 10:54:00,64.7
Handheld Vacuums,1,1,1,0,1,2017-04-29 12:18:00,inf
Upright Vacuums,2,1,1,0,1,2019-11-16 11:02:00,inf
Router Accessories,5,2,0,2,2,2022-12-28 19:00:00,100.0
Router Edge Guides,1,1,0,1,2,2022-12-28 19:00:00,200.0
Router Bits,9,6,0,6,0,,0.0
Straight Router Bits,1,4,0,4,0,,0.0
Molding Router Bits,1,1,0,1,0,,0.0
Corded Grinders,1,1,0,1,2,2022-11-08 21:03:00,200.0
Electric Nailers,1,1,0,1,2,2022-12-13 17:58:00,200.0
Steam Cleaners,5,6,3,3,4,2021-10-13 18:18:00,133.3
Carpet Steam Cleaners,1,4,1,3,4,2021-10-13 18:18:00,133.3
Cordless Power Tools,16,114,55,59,54,2022-12-27 18:55:00,91.5
Cordless Drills,1,53,34,19,23,2022-12-27 18:55:00,121.1
Flashlights,1,14,3,11,3,2020-10-03 09:36:00,27.3
Cordless Trimmers,1,11,4,7,6,2019-06-24 19:24:00,85.7
Cordless Saws,2,8,1,7,9,2022-11-19 11:09:00,128.6
Cordless Circular Saw,1,4,1,3,4,2022-11-19 11:09:00,133.3
Cordless Screwdrivers,1,3,0,3,1,2018-07-18 19:44:00,33.3
Cordless Vacuums,1,2,1,1,2,2022-02-08 21:01:00,200.0
Cordless Impact Drivers,1,5,2,3,2,2017-12-13 20:59:00,66.7
Cordless Tool Batteries,4,53,26,27,10,2022-10-15 10:29:00,37.0
12V Cordless Tool Batteries,1,9,3,6,2,2018-09-18 16:42:00,33.3
18V Cordless Tool Batteries,1,19,8,11,5,2018-08-11 11:34:00,45.5
20V Cordless Tool Batteries,1,15,6,9,6,2021-10-09 11:29:00,66.7
Cordless Hammer Drills,1,3,0,3,6,2022-11-08 20:38:00,200.0
Cordless Hedge Trimmers,1,1,0,1,1,2021-05-15 11:51:00,100.0
Grinders,4,17,8,9,6,2018-07-08 15:24:00,66.7
Bench Grinders,1,4,2,2,2,2022-12-11 18:40:00,100.0
Angle Grinders,1,10,4,6,6,2018-07-08 15:24:00,100.0
Lathes,1,4,1,3,1,2016-05-11 19:01:00,33.3
Power Sharpeners,2,1,1,0,1,2017-05-20 11:13:00,inf
Joiners,4,2,0,2,2,2018-09-16 17:39:00,100.0
Biscuit Joiners,1,2,0,2,2,2018-09-16 17:39:00,100.0
Power Tool Accessories,1,3,0,3,4,2022-06-29 18:37:00,133.3
Air & Pneumatic Tools,17,45,15,30,12,2022-11-12 12:04:00,40.0
Compressors,1,9,2,7,8,2022-11-12 12:04:00,114.3
Air Tool Sets,1,1,0,1,1,2020-07-25 12:06:00,100.0
Jacks,3,14,5,9,3,2021-04-10 10:09:00,33.3
House Jack,1,7,1,6,2,2016-06-18 11:38:00,33.3
Air Brad Nailers,1,3,1,2,1,2020-03-01 16:23:00,50.0
Air Finish Nailers,1,3,1,2,2,2017-02-25 09:49:00,100.0
Air Staplers,1,3,2,1,1,2017-09-13 18:36:00,100.0
Air Wrenches,1,1,1,0,0,,
Air Sanders,1,1,0,1,0,,0.0
Bike Tools,9,80,11,69,10,2018-09-16 18:11:00,14.5
Bottom Bracket Tools,1,4,0,4,3,2019-09-15 17:09:00,75.0
Drive Train Tools,1,20,4,16,5,2017-05-10 21:06:00,31.2
Wheel Tools,1,29,4,25,8,2022-05-29 17:34:00,32.0
Bike Repair Stands,1,3,0,3,1,2016-11-02 18:57:00,33.3
Propane & Gas Powered Tools,12,6,1,5,2,2018-09-30 16:38:00,40.0
Propane Torch Kit,1,6,1,5,2,2018-09-30 16:38:00,40.0
Meters & Diagnostics,22,33,11,22,9,2021-10-23 12:03:00,40.9
Multimeters,1,15,5,10,8,2021-10-23 12:03:00,80.0
Power Meters,4,2,1,1,1,2021-01-09 12:12:00,100.0
Non-logging Power Meters,1,1,0,1,1,2021-01-09 12:12:00,100.0
Distance Meters,1,1,0,1,1,2019-12-23 18:46:00,100.0
Detectors,1,1,0,1,0,,0.0
Tachometers,1,1,0,1,0,,0.0
Wheelbarrows & Wagons,3,3,0,3,2,2020-03-08 17:35:00,66.7
Wheelbarrow,1,3,0,3,2,2020-03-08 17:35:00,66.7
Safety Equipment,11,62,13,49,9,2017-05-17 19:12:00,18.4
Work Gloves,1,20,7,13,9,2017-05-17 19:12:00,69.2
Protective Goggles,1,10,1,9,3,2018-05-19 12:12:00,33.3
Respirators,1,4,0,4,3,2022-09-03 12:14:00,75.0
Safety Glasses,1,15,1,14,2,2019-05-11 10:40:00,14.3
Hearing Protection,3,3,0,3,2,2021-06-19 09:58:00,66.7
Ear Muffs,1,3,0,3,2,2021-06-19 09:58:00,66.7
Automotive Tools,10,72,11,61,25,2022-11-19 11:09:00,41.0
Jack Stands,1,12,1,11,10,2022-10-15 11:54:00,90.9
Automotive Jacks,1,9,3,6,5,2022-04-09 12:07:00,83.3
Garage Jacks,1,1,0,1,2,2022-10-15 11:54:00,200.0
Automotive Ramps,1,2,0,2,2,2020-03-08 18:16:00,100.0
Automotive Pressure Gauges,1,3,0,3,1,2018-11-03 11:44:00,33.3
Fencing Tools,8,7,1,6,3,2017-05-31 20:22:00,50.0
Post Hole Digger,1,7,1,6,3,2017-05-31 20:22:00,50.0
Garden Tools,15,70,11,59,7,2022-07-26 18:47:00,11.9
Weeders,3,12,1,11,3,2017-06-24 09:46:00,27.3
Hoes,1,19,5,14,4,2017-10-04 16:34:00,28.6
Seeders,4,3,0,3,1,2022-03-26 11:30:00,33.3
Hand Seeders,1,3,0,3,1,2022-03-26 11:30:00,33.3
Hand Tillers,1,1,0,1,1,2017-03-25 10:45:00,100.0
Planting Templates,2,1,0,1,1,2019-03-03 18:27:00,100.0
Garden Hoses,1,26,5,21,3,2022-02-22 18:30:00,14.3
Farm Tools,5,1,0,1,0,,0.0
Tractor Accessories,13,2,0,2,1,2016-07-13 18:53:00,50.0
Manure Spreaders,1,2,0,2,1,2016-07-13 18:53:00,50.0
Tree & Orchard Care Tools,12,37,17,20,8,2022-06-29 20:50:00,40.0
Chainsaws,7,6,3,3,5,2022-12-18 17:42:00,166.7
Pruning Saw,1,2,0,2,1,2017-12-30 10:59:00,50.0
Pruning Shears,1,29,14,15,4,2019-06-09 18:24:00,26.7
Orchard Sprayers,3,1,0,1,0,,0.0
Hand Pump Orchard Sprayers,1,1,0,1,0,,0.0
Welding,9,2,1,1,2,2018-11-14 19:25:00,200.0
Welders,1,2,1,1,2,2018-11-14 19:25:00,200.0
Welding Safety Equipment,10,4,1,3,2,2018-07-22 17:56:00,66.7
Welding Gloves,1,1,0,1,1,2022-01-16 18:36:00,100.0
Welding Helmets,1,3,1,2,2,2018-07-22 17:56:00,100.0
MIG Welding,5,1,0,1,1,2021-04-27 20:47:00,100.0
MIG Welders,1,1,0,1,1,2021-04-27 20:47:00,100.0
"Chains, Ropes, and Straps",5,41,23,18,5,2022-12-07 19:03:00,27.8
Chains,1,2,0,2,1,2019-12-21 11:50:00,50.0
Bungee Cords,1,14,0,14,5,2022-12-07 19:03:00,35.7
Ropes,1,25,23,2,1,2017-12-13 18:12:00,50.0
Flooring Tools,4,19,4,15,7,2022-12-21 20:41:00,46.7
Carpet Tools,4,9,2,7,4,2022-12-06 21:16:00,57.1
Carpet Roller,1,2,0,2,1,2018-04-28 10:38:00,50.0
Tile Cutters,3,11,1,10,3,2022-09-03 09:48:00,30.0
Hand Tile Cutter,1,6,1,5,2,2017-08-12 11:15:00,40.0
Tile Nipper,1,2,0,2,1,2017-09-13 17:12:00,50.0
Laminate Flooring Cutters,1,1,0,1,1,2022-01-04 18:28:00,100.0
Kitchen & Dining,30,101,22,79,12,2019-07-13 11:16:00,15.2
"Canning, Preserving & Homebrew",1,13,5,8,3,2019-07-13 11:16:00,37.5
Appliances,1,9,5,4,2,2017-09-30 11:50:00,50.0
Cook's Tools,1,10,3,7,2,2020-08-29 12:01:00,28.6
Other Kitchen & Serving,1,11,3,8,2,2017-09-13 16:12:00,25.0
Food Service Displays,1,1,0,1,1,2018-11-20 18:51:00,100.0
Glassware & Drinkware,6,14,0,14,4,2019-07-10 19:17:00,28.6
Glassware,1,1,0,1,1,2018-02-17 12:04:00,100.0
Mugs,3,1,0,1,0,,0.0
Ceramic Mugs,1,1,0,1,0,,0.0
Food Storage,1,12,2,10,4,2019-07-10 19:17:00,40.0
Kitchen Gadgets,1,4,0,4,2,2022-06-26 16:59:00,50.0
Plates & Bowls,3,2,0,2,1,2022-08-31 19:53:00,50.0
Plates,5,1,0,1,1,2021-04-13 18:08:00,100.0
Dinner Plates,1,1,0,1,1,2021-04-13 18:08:00,100.0
Small Appliances,7,32,6,26,12,2022-12-28 18:22:00,46.2
Grain Mills,1,2,0,2,4,2022-12-18 18:08:00,200.0
Ice Cream Makers,1,5,1,4,2,2017-08-02 21:07:00,50.0
Bread Makers,1,1,0,1,1,2019-01-20 18:24:00,100.0
Instant Pots,1,1,0,1,2,2022-09-25 18:14:00,200.0
Slow Cookers,1,5,2,3,2,2018-03-28 17:47:00,66.7
Pots & Pans,1,1,0,1,0,,0.0
Induction Cooking,3,4,0,4,2,2022-12-28 18:15:00,50.0
Induction Cooktops,1,4,0,4,2,2022-12-28 18:15:00,50.0
Kitchen Appliances,1,1,0,1,1,2018-06-10 20:36:00,100.0
Books & Media,14,9,1,8,4,2022-07-31 18:12:00,50.0
Books,10,5,0,5,4,2022-07-31 18:12:00,80.0
Magazines,1,1,0,1,0,,0.0
DVD,1,2,0,2,0,,0.0
CD-ROM,1,1,1,0,0,,
Electronics,35,24,11,13,5,2022-11-13 19:07:00,38.5
Lights,2,13,3,10,12,2022-12-04 18:59:00,120.0
Work Lights,4,23,3,20,15,2022-12-04 18:59:00,75.0
Clamp Lights,1,2,0,2,2,2022-12-04 18:59:00,100.0
Hanging Lights,1,11,2,9,4,2022-10-23 16:52:00,44.4
Network Equipment,5,2,0,2,0,,0.0
Network Switches,1,1,0,1,0,,0.0
Network Accessories,2,3,0,3,0,,0.0
Network Cables,1,3,0,3,0,,0.0
Video Gaming,4,3,1,2,0,,0.0
Controllers,1,1,0,1,0,,0.0
Video Game Accessories,1,2,1,1,0,,0.0
Computers,15,21,2,19,8,2022-08-27 12:04:00,42.1
Laptop Computers,4,9,3,6,7,2022-12-13 20:36:00,116.7
Windows Laptops,1,6,2,4,5,2022-12-13 20:36:00,125.0
Computer Accessories,5,2,0,2,1,2021-10-05 19:40:00,50.0
Keyboards & Mice,6,4,1,3,2,2022-08-27 12:04:00,66.7
Wired Keyboards,1,1,1,0,0,,
Wired Mice,1,1,0,1,2,2022-08-27 12:04:00,200.0
Monitors and Displays,1,6,1,5,2,2017-12-06 15:57:00,40.0
Computer Power Adapters,1,6,0,6,1,2021-07-24 09:37:00,16.7
Computer Cables,9,12,3,9,5,2022-08-10 19:55:00,55.6
USB-A Cables,1,7,3,4,2,2021-10-05 19:40:00,50.0
USB-C Cables,1,2,0,2,1,2022-08-09 19:37:00,50.0
Displayport Cables,1,1,0,1,1,2022-08-10 19:55:00,100.0
USB Chargers,1,2,0,2,0,,0.0
Printers & Scanners,6,9,1,8,4,2022-10-12 20:08:00,50.0
3D Printers,1,5,1,4,2,2022-07-02 11:50:00,50.0
Printer Accessories,1,1,0,1,1,2022-08-03 18:54:00,100.0
Label Makers,1,1,0,1,2,2022-09-28 18:31:00,200.0
Laser Printers,4,1,0,1,0,,0.0
Black & White Laser Printers,1,1,0,1,0,,0.0
Inkjet Printers,3,2,1,1,1,2018-10-13 10:13:00,100.0
Multifunction Inkjet Printers,1,1,1,0,0,,
Video & Photography,22,16,6,10,4,2022-12-18 17:18:00,40.0
Projectors,6,2,2,0,2,2017-07-29 11:26:00,inf
TVs,1,2,2,0,0,,
Video Cables,6,2,0,2,1,2022-08-10 19:55:00,50.0
HDMI Cables,1,2,0,2,1,2022-08-10 19:55:00,50.0
Video Adapters,1,3,0,3,2,2022-12-10 12:10:00,66.7
Camera Equipment,3,1,0,1,2,2022-12-18 17:18:00,200.0
Camera Lighting Equipment,1,1,0,1,2,2022-12-18 17:18:00,200.0
Projector Screens,1,2,0,2,1,2016-09-04 18:55:00,50.0
Camera Tripods,1,4,0,4,2,2022-12-18 17:18:00,50.0
Video Switchers,1,1,1,0,0,,
Video Players & Recorders,4,2,1,1,2,2022-10-02 18:18:00,200.0
Blu-ray Players,1,1,0,1,1,2022-08-30 19:21:00,100.0
Sensors,5,1,1,0,0,,
Communications Devices,8,2,0,2,1,2021-05-04 18:13:00,50.0
Telephones,4,2,0,2,1,2021-05-04 18:13:00,50.0
Smartphones,3,2,0,2,2,2022-05-15 19:03:00,100.0
iPhones,1,2,0,2,2,2022-05-15 19:03:00,100.0
Other Electronic Devices,1,1,1,0,0,,
Shredders,1,1,0,1,1,2022-07-24 16:14:00,100.0
Barcode & RFID Scanners,3,2,0,2,0,,0.0
Barcode Scanners,1,2,0,2,0,,0.0
Data Storage Devices,6,6,0,6,2,2022-07-19 19:01:00,33.3
USB Flash Drives & Memory Cards,1,6,0,6,2,2022-07-19 19:01:00,33.3
VR Gear,1,2,1,1,1,2021-04-03 09:19:00,100.0
Power,5,14,3,11,2,2022-02-08 21:01:00,18.2
Power Adapters,3,7,3,4,1,2022-01-15 15:23:00,25.0
AC Adapters,1,4,0,4,1,2022-01-15 15:23:00,25.0
Power Strips & Surge Protectors,3,13,3,10,6,2020-03-09 19:18:00,60.0
Power Strips,1,12,3,9,5,2020-03-09 19:18:00,55.6
Surge Protectors,1,1,0,1,1,2020-03-09 19:18:00,100.0
Power Plug & Socket Adapters,1,7,0,7,1,2018-05-20 16:27:00,14.3
Audio,21,9,1,8,8,2022-12-11 18:40:00,100.0
Microphones,7,2,0,2,2,2021-09-29 19:37:00,100.0
Speakers & Amplifiers,3,1,0,1,0,,0.0
Audio Accessories,4,1,0,1,0,,0.0
Audio Cables,9,1,0,1,0,,0.0
Audio Recording Gear,4,1,1,0,1,2019-05-15 20:21:00,inf
Audio Mixers,4,1,0,1,1,2019-08-31 11:39:00,100.0
Public Address Systems,1,3,0,3,6,2022-12-10 12:07:00,200.0
Microphone Stands,1,1,0,1,0,,0.0
Sports & Outdoors,38,61,18,43,8,2022-03-13 16:14:00,18.6
Snowboards,1,1,0,1,0,,0.0
Goggles,1,3,0,3,1,2021-06-12 10:03:00,33.3
Boats & Rafts,1,1,0,1,1,2022-07-30 10:22:00,100.0
Skates,1,1,0,1,0,,0.0
Camping & Hiking,17,23,9,14,10,2022-06-08 21:42:00,71.4
Tents,3,5,1,4,3,2022-04-13 18:53:00,75.0
Hiking Backpacks,3,3,1,2,3,2022-05-07 09:34:00,150.0
Camp Stoves,5,3,2,1,2,2022-05-07 09:34:00,200.0
Two Burner Camp Stoves,1,1,0,1,2,2022-05-07 09:34:00,200.0
Liquid Fuel Stoves,1,1,1,0,1,2021-05-29 10:03:00,inf
Water Bottles,1,1,0,1,1,2017-09-06 17:35:00,100.0
Sleeping Bags,2,1,0,1,1,2017-06-21 20:04:00,100.0
Sleeping Pads,3,6,3,3,5,2018-08-21 16:29:00,166.7
Foam Sleeping Pads,1,1,0,1,1,2018-06-08 13:28:00,100.0
Air Mattress Sleeping Pads,1,2,2,0,1,2017-07-19 19:57:00,inf
Camping Tarps,1,3,3,0,2,2018-04-21 09:53:00,inf
Camping & Hiking Storage,2,1,0,1,1,2022-04-23 12:54:00,100.0
Camping Furniture,4,6,0,6,3,2020-08-22 12:06:00,50.0
Camping Chairs,1,6,0,6,3,2020-08-22 12:06:00,50.0
Telescopes & Binoculars,4,6,3,3,2,2016-09-18 18:39:00,66.7
Telescopes,7,4,3,1,2,2016-09-18 18:39:00,200.0
Sports & Outdoor Accessories,4,9,1,8,2,2017-10-29 18:10:00,25.0
Headlamps,1,3,0,3,2,2017-10-29 18:10:00,66.7
Winter Sports,8,3,1,2,2,2021-02-13 10:33:00,100.0
Climbing & Mountaineering,10,7,4,3,2,2018-06-20 20:38:00,66.7
Climbing Harnesses,1,1,0,1,0,,0.0
Outdoors Safety,9,3,0,3,0,,0.0
Water Safety,4,3,1,2,1,2020-09-05 12:11:00,50.0
Personal Flotation Devices,4,3,1,2,1,2020-09-05 12:11:00,50.0
Bicycle Accessories,7,8,0,8,2,2022-11-06 16:22:00,25.0
Bicycle Trailers,1,1,0,1,1,2019-06-26 21:50:00,100.0
Rafts,1,8,0,8,4,2020-02-22 13:09:00,50.0
Water Sports,8,4,0,4,1,2019-09-01 18:00:00,25.0
Kayaking Gear,4,1,0,1,0,,0.0
Wetsuits,1,3,0,3,1,2019-09-01 18:00:00,33.3
Outdoor Recreation,7,1,0,1,1,2017-08-05 10:05:00,100.0
BBQ Grills,1,1,0,1,1,2017-08-05 10:05:00,100.0
Marine & Fishing,8,16,11,5,4,2022-03-13 16:14:00,80.0
Traps & Pots,3,2,1,1,1,2019-05-08 20:52:00,100.0
Music,13,3,2,1,0,,0.0
Guitars,11,2,2,0,0,,
Musical Instrument Accessories,10,1,0,1,0,,0.0
Vehicles & Trailers,16,7,3,4,3,2019-01-12 09:47:00,75.0
Cars,2,1,1,0,0,,
Hitches & Towing Accessories,3,18,2,16,9,2022-11-12 12:04:00,56.2
Ratchet Straps,1,16,2,14,9,2022-11-12 12:04:00,64.3
Earthmoving Equipment,5,2,1,1,2,2019-01-12 09:47:00,200.0
Clothing,21,3,2,1,1,2018-05-16 20:09:00,100.0
Footwear,7,1,0,1,0,,0.0
Boots,2,1,0,1,0,,0.0
Jewelry & Accessories,8,1,0,1,1,2018-05-16 20:09:00,100.0
Personal Protective Equipment,5,1,1,0,0,,
Personal Protective Head Gear,3,2,0,2,0,,0.0
Helmets,1,1,0,1,0,,0.0
Hard Hats,1,1,0,1,0,,0.0
Eye Protection,1,1,1,0,0,,
Headwear,4,1,0,1,1,2021-12-10 20:33:00,100.0
Hats,3,1,0,1,1,2021-12-10 20:33:00,100.0
Bags,6,1,1,0,0,,
Handbags,3,2,1,1,0,,0.0
Totes,1,1,0,1,0,,0.0
Toys & Games,8,11,4,7,2,2019-07-10 20:55:00,28.6
Games,6,26,12,14,4,2022-07-30 09:14:00,28.6
Board Games,1,22,9,13,4,2022-07-30 09:14:00,30.8
Other Games,1,2,2,0,2,2017-06-10 11:45:00,inf
Toys,1,3,0,3,0,,0.0
Activities,1,2,1,1,0,,0.0
Furniture & Spaces,22,31,11,20,6,2022-12-07 21:01:00,30.0
Offices,1,2,0,2,2,2022-12-07 21:01:00,100.0
Gardens,1,2,2,0,1,2018-06-24 19:03:00,inf
Furniture,8,21,9,12,4,2022-11-30 19:19:00,33.3
Chairs,3,43,1,42,42,2018-11-17 10:12:00,100.0
Folding Chairs,1,42,0,42,42,2018-11-17 10:12:00,100.0
Tables,2,17,5,12,5,2017-05-10 19:52:00,41.7
Folding Tables,1,12,0,12,5,2018-06-02 10:17:00,41.7
Storage Furniture,1,1,0,1,1,2021-03-30 20:10:00,100.0
Miscellaneous Furniture,1,14,3,11,4,2022-11-30 19:19:00,36.4
Keys,1,1,0,1,0,,0.0
Storage & Organization,7,26,10,16,4,2022-04-13 18:53:00,25.0
Storage Bins,2,6,3,3,2,2021-03-23 20:06:00,66.7
Waste & Trash Baskets,1,1,1,0,1,2021-01-23 09:21:00,inf
Laundry Organization,6,5,2,3,2,2019-09-22 17:22:00,66.7
Ironing Boards,1,1,1,0,0,,
Steam Irons,1,4,1,3,2,2019-09-22 17:22:00,66.7
Moving Supplies,6,7,1,6,4,2018-03-17 10:49:00,66.7
Moving Blankets,1,5,0,5,4,2018-03-17 10:49:00,80.0
Moving Carts,1,1,1,0,1,2017-09-16 11:45:00,inf
Cleaning,2,2,0,2,1,2022-04-12 19:08:00,50.0
Brooms & Mops,5,11,1,10,2,2019-02-16 10:50:00,20.0
Push Brooms,1,7,1,6,2,2019-02-16 10:50:00,33.3
House Broom,1,1,0,1,1,2016-10-29 10:33:00,100.0
Brooms,1,3,0,3,1,2020-09-26 11:08:00,33.3
Stage & Screen,9,1,1,0,0,,
Other Props,1,1,1,0,0,,
Bedding,5,1,0,1,0,,0.0
Pillows,1,1,0,1,0,,0.0
Pets,4,3,1,2,1,2017-03-13 21:22:00,50.0
Pet Carriers,1,3,1,2,1,2017-03-13 21:22:00,50.0
Yardshares,1,1,0,1,0,,0.0
Medical Equipment,21,2,0,2,1,2019-12-21 11:50:00,50.0
Medical Diagnostics,5,3,1,2,2,2022-12-13 21:13:00,100.0
Thermometers,1,3,1,2,2,2022-12-13 21:13:00,100.0
Walking Aids,8,6,2,4,2,2021-03-06 11:01:00,50.0
Walkers,1,1,0,1,0,,0.0
Knee Wheelers & Scooters,1,3,2,1,2,2021-03-06 11:01:00,200.0
Rollators & Rolling Walkers,1,1,0,1,1,2022-06-23 19:14:00,100.0
Canes,1,1,0,1,0,,0.0
Bathroom Safety,5,2,0,2,0,,0.0
Shower Chairs & Benches,4,1,0,1,0,,0.0
Bathroom Grab Bars,1,1,0,1,0,,0.0
Medical Braces,8,2,1,1,0,,0.0
Knee Braces,1,1,0,1,0,,0.0
Walking Boots & Braces,1,1,1,0,0,,
Medical Trauma Kit,3,1,0,1,1,2019-12-21 11:50:00,100.0
Art,8,52,14,38,4,2022-09-03 11:14:00,10.5
Fiber Arts,1,20,6,14,3,2017-09-16 12:15:00,21.4
Ceramic & Glass Arts,1,15,5,10,1,2017-11-15 17:56:00,10.0
Wood & Metal Arts,1,2,1,1,0,,0.0
Materials,9,8,1,7,2,2017-12-06 19:53:00,28.6
Wood,1,1,1,0,1,2016-07-09 11:56:00,inf
Science & Engineering,5,2,0,2,1,2021-08-11 19:12:00,50.0
Research Equipment,1,1,0,1,0,,0.0
Lab Instruments & Equipment,7,3,0,3,1,2021-02-27 11:30:00,33.3
Microscopes,1,3,0,3,1,2021-02-27 11:30:00,33.3
General Measurement,1,1,0,1,1,2021-08-11 19:12:00,100.0
Hobbies & Crafts,10,76,38,38,16,2022-11-22 19:53:00,42.1
Sewing Machines,1,11,4,7,9,2022-12-10 09:46:00,128.6
Hobby & Craft Kits,1,3,1,2,4,2022-10-26 18:42:00,200.0
Scissors,1,19,7,12,4,2021-12-05 16:22:00,33.3
Electrical Equipment,9,1,0,1,0,,0.0
Party & Events,9,2,0,2,1,2022-05-31 20:58:00,50.0
Recycling & Waste Management,5,1,0,1,1,2022-05-31 20:58:00,100.0
Beverage Service Equipment,8,1,0,1,0,,0.0
Portable Heating & Cooling,3,1,0,1,0,,0.0
Fan Heaters,1,1,0,1,0,,0.0
Office & Industrial,3,2,0,2,2,2022-11-22 19:53:00,100.0
Cubicles,1,1,0,1,2,2022-11-22 19:53:00,200.0
